Cell barcode	SW
AACACCTGATTCCAGGTACT	CACTCAGAGAGTGACTGTGACTCTG
AACAGACGACCACCGAGCAT	unknown
AACAGAGACTAGTGTTGCTT	unknown
AACAGAGACTGTTCGCGCGC	unknown
AACAGCATAGTAGCGCACGT	unknown
AACATATGGCAGACTTACGT	unknown
AACATATGGCCAACTCGTCG	unknown
AACATTCCTCAATAATGCAC	GTGAGTGAGTCTCAGTGACTCTCAGAGT
AACATTCCTCAATAATGCAC	GAACGTCTCAGTGTCAGACACTGAC
AACATTCCTCCAGTCCAGGA	unknown
AACCATATACACGGCGAGGC	unknown
AACCATATACGACTTACTCT	GTGACTGTCTCACTCAGAGAGTCACTGA
AACCATATACGACTTACTCT	GTGACTGTCTCACTCAGAGAGTCACAGA
AACCATATACGACTTACTCT	GTGACTGTCTCACTCAGAGAGTCACTGA
AACCTGGTGAGAGACAACGG	unknown
AACCTTGCGGCGAGGAGTCA	CGTGTGAGTGTGACTCTGAGAGA
AACCTTGCGGCGAGGAGTCA	CGTGTGAGTGTGACTCTGAGAGACTCT
AACCTTGCGGCTCAACATGT	unknown
AACCTTGCGGGTCACGTGCT	unknown
AACCTTGCGGTAACAGCCAA	unknown
AACCTTGCGGTCCAGGTACT	unknown
AACCTTGCGGTCGCATCTTG	unknown
AACGAGTATTCCTGCTTAGT	unknown
AACGAGTATTCTCGCAGGTC	TGACAGTGTGTGTCAGTGTCAGAGAGAG
AACGAGTATTGCTTCTGTAC	unknown
AACGCAATTATCCAATAGAA	unknown
AACGGTCTTGCACCGAGCAT	unknown
AACGGTTGAGATGATCATTA	unknown
AACGGTTGAGCATGGACTCC	CGTGTGTCTGTGTGTCTGTGTGACTGT
AACGGTTGAGCATGGACTCC	GTCTGTCTCTCTGTCAGAGTGTGGCTCA
AACGGTTGAGGCTTAGATCT	unknown
AACGTATCTGAGGCACACCT	GACTCAGAGTCACAGTCAGAGACAGTGA
AACGTATCTGAGGCACACCT	GACTCAGAGTCACAGTCAGAGACTGTGA
AACGTATCTGCATGCTGACT	unknown
AACGTATCTGTACTCAGGAA	CGTCTCTCAGTCAGAGTCTCACACTCAG
AACGTATCTGTACTCAGGAA	CGTCTCTCAGTCAGAGACTCACACTCA
AACGTATCTGTTCGCATAAT	unknown
AACGTCACACCAAGCCTTAG	GTGTGTCTCTCTGTCAGAGTGGGTCTCA
AACGTCACACCAAGCCTTAG	GTCTCACTGTCAGTGTGTGAGACAGGTT
AACGTGCGTTAATCTACAAG	unknown
AACGTGCGTTGAACGCCGTG	GTGTGAGTGTGACTCTGAGAGACTCTCT
AACGTGCGTTTCGACATCGA	unknown
AACTGAGCGGAGTGGACACC	unknown
AACTTCCAGGGACCAGTACG	unknown
AACTTGCACCCCTGTGAAGT	unknown
AACTTGCACCTCCTGGTCGG	TCGTTTGACTCAGACTGTGTGTGTGTGT
AACTTGCACCTCCTGGTCGG	GTCTGACTCAGACTGTGTGTGTGTGTCT
AAGAAGTCACAGGAGCTCCA	unknown
AAGAAGTCACGCCAGCACGT	unknown
AAGACCTAGGGACCAGTACG	unknown
AAGACGTACCACCAATCTAA	unknown
AAGATCAATTATATTCTCAC	unknown
AAGATCAATTATGTCCGTGC	unknown
AAGATCAATTCAGTCCAGGA	unknown
AAGATCAATTCCGTGCAACC	GTCTGTCTCTCTGTCAGAGTGTGTCTCA
AAGATCAATTGAGGTGCCGC	unknown
AAGATGGCCTAGCAGGCAGC	unknown
AAGATGGCCTGGAGGTCCAA	unknown
AAGATTAACCACCAATCTAA	GTATGTCTCTCTGTCAGAGTGTGTCTCA
AAGATTAACCACCAATCTAA	CGTGTGTCTCTCTGTCAGAGTGT
AAGCGATTCCAATGCCAGTT	unknown
AAGCGATTCCATGATCATTA	unknown
AAGCGATTCCTCCAATAGAA	ACTCTCACACTCTCTCTGTCAGTCTCAG
AAGCGCCGTAGACTGTTCCT	GTGTGTCTGTGTGTCTGTGTGACTGTGA
AAGGAATGTACGACGGACGA	GTTTGTCTCTCTGTCAGAGTGTGTCTCA
AAGGAATGTACGCGAGTCGA	GTATGTCTCTCTGTCAGAGTGTGTCTCA
AAGGAATGTAGTCAGTACCA	unknown
AAGGAATGTATGTATTCAGA	unknown
AAGGACCTCCCTTCGGCCGG	unknown
AAGGAGCTGGCGCTGAATTC	unknown
AAGGATCCGACTTCCATCCT	unknown
AAGGATCCGATCATCGGATT	TGTCAGTGTGTCTGTCTGTGAGTCTCTG
AAGGATTGATAAGCGCCGTA	TGAGTGAGTGTCTGAGTCTGTCTCTCAG
AAGGATTGATATACTCCTAC	unknown
AAGGTACATAATCGGACAAG	CGACAGAGTCACTGAGTGAGTGA
AAGGTACATAATCGGACAAG	CGACAGAGTCACTGAGTGAGTGAC
AAGGTACATAATCGGACAAG	GACAGAGTCACTGAGTGAGTGACAGAGT
AAGGTACATAGCTGTGAGAC	unknown
AAGGTCGGTTATCTCGCTGC	unknown
AAGGTTGGCCCTGCAGGATA	CGACTGTGAGTCACTCACTGT
AAGGTTGGCCGATAATGATG	unknown
AAGGTTGGCCGTAATACGTC	unknown
AAGTAAGCGTAGTGGTGGTA	unknown
AAGTAAGCGTTCTAATGACG	unknown
AAGTAAGTTAGGTGCAACCT	CGACTCAGAGTAACAGT
AAGTACTAATTACGCCGATT	unknown
AAGTCACGGCGTCACGTGCT	GACACACTGACTGTGTGAGTCTCAGAGT
AAGTCACGGCTCGACATCGA	ACTCAGAGAGTGACTGTGACTCTGTCTG
AAGTCCTCCTCTTCCTACAG	unknown
AAGTCGATCCAATTCCAACC	unknown
AAGTGCTGGTCATCAATTAA	unknown
AAGTTCGACCCGATTGATAA	unknown
AAGTTGGAGGCGCCTGGAGA	unknown
AAGTTGGAGGGAACGCCGTG	AGTGTGAGAGTCTGTGAGTCAGTGTCTG
AATAATGCACAAGTCGATCC	unknown
AATAATGCACAGAATTCAGT	unknown
AATAATGCACGTTCGCGCGC	GTGTGAGTGTGACTCTGAGAGACTCTCT
AATAATGCACGTTCGCGCGC	GTGTGAGTGTGACTCTGAGAGACTCTCT
AATACATTAATAGTTAGACG	GTGTGAGTGTGACTCTGAGAGACTCTCT
AATACATTAATAGTTAGACG	CGTGTGAGTGTGACTCTGAGAGACTCT
AATACATTAATAGTTAGACG	GTGTGAGTGTGACTCTGAGAGACTCTCT
AATACCGATTGACCAGTACG	unknown
AATACCGATTTGGTATTGTC	unknown
AATACCTTCCGACGAAGACT	unknown
AATACCTTCCGCACTTCACG	ACTCTCACACTCTCTCTGTCAGTCTCAG
AATACCTTCCGCACTTCACG	CACTCTCACACTCTCTCTGT
AATACGACCTGTTAAGGTGA	CGTGTGTCTCAGACAGACTGT
AATACGACCTGTTAAGGTGA	GTGTGTCTCAGACAGACTGTCTGTCTGT
AATACGACCTGTTAAGGTGA	CGTGTCTCTCTGTCTGACTCTGTGTG
AATACGTTGGGGCTCCAAGC	unknown
AATACTCGATAATAATGCAC	unknown
AATACTCGATCGCCTGGAGA	unknown
AATACTCGATCTTGTCTAGT	unknown
AATAGACTCTCAGCAAGCAG	GACGTGTCACTCTGTGTGTCTGTCACTG
AATAGACTCTCCTGCTTAGT	GTCTGTCTCTCTGTCAGAGTGTGTCTCA
AATAGACTCTGTGGACAGGA	unknown
AATAGTAGTGACAGTCCACC	unknown
AATAGTTGCAGCGAATCGAC	GTGAGTGAGTCTCAGTGACTCTCAGAGT
AATAGTTGCAGCGAATCGAC	GTGAGTGAGTCTCAGTGACTCTCAGAGT
AATATGACGAGCCGCAATAG	unknown
AATATTATGGACATAGGTGG	GTGAGTCTGACTCTGTCTCTCTGACTGT
AATCAACTTGGCAGGTATCC	CGTGAGTGACACAGTGTGAGAGTCTGTC
AATCAACTTGGTCTACCTTC	GACTCTGTGTCTCACTGTGAGAGTGACT
AATCACAGTCAATTCGAAGG	unknown
AATCAGTGGACAGGAACGAG	unknown
AATCAGTGGAGTAGTTCTAG	GTGTGTCTGTGTGTCTGTGTGACTGTGA
AATCCGCACTCATGCTGACT	unknown
AATCCGCACTCGCCTCATCT	unknown
AATCCGCACTGCTCGGTATG	GTGAGTGAGTCTCAGTGACTCTCAGAGT
AATCGCGCAGAGAGAGTCGC	CGAGACTGTGTCTGTGTGACT
AATCGCGCAGTACAGTACGC	unknown
AATCTACAAGAATAATGCAC	unknown
AATCTACAAGATCGAGCGAA	unknown
AATCTACAAGCATATTAGGA	CGTAACACACTCACTGAGTGTCAG
AATCTACAAGCATATTAGGA	GTCTGTCTCTCTGTCAGAGTGTGTCTCA
AATCTACAAGTCCTGGTCGG	GTCTCTCAGTCAGAGACTCACACTCAGT
AATGCCAGTTCCATCGTGAC	unknown
AATGCCAGTTTATTACTCTC	unknown
AATGGCCGAGATGGAAGGCC	GTCTCTCAGTCAGAGACTCACACTCAGT
AATGGCCGAGATGGAAGGCC	GTCTCTCAGTCAGAGACTCACACTCAGT
AATGGTACGCATGTCCGTGC	CGTGTGAGTGTGACTCTGAGAGACTCT
AATGGTACGCTCTTCATCTC	unknown
AATTAATCTGCCTGTGAAGT	unknown
AATTCCAACCCGCCTGGAGA	CACTCTCACACTCTCTCTGTCAGTCTC
AATTCCAACCTGGACGTGAC	unknown
AATTCGAAGGCGTATCGCCT	GAGAGACTGTCACTGTCTCTGACACTGT
AATTCGAAGGCGTATCGCCT	GAGAGACTGTCACTGTCTCTGACACTGT
AATTCGAAGGTGATGACGTA	unknown
AATTCTAATTAGACCGTCGT	GTGTGAGTGTGACTCTGAGAGACTCTCT
AATTCTAATTCTCACCTAAG	unknown
AATTCTAATTTGCAGTGGTA	CACTCAGAGAGTGACTGTGACT
AATTGCGGTGGCCAGCTTCG	GTGACACTGTCTCAGAGACTGACAGAGA
AATTGCGGTGGCCAGCTTCG	GTGACACTGTCTCAGAGACTGACAGAGA
AATTGCGGTGGCCAGCTTCG	GTGACACTGTCTCAGAGACTGACAGAGA
AATTGCGGTGGCCAGCTTCG	CGTGACACTGTCTCAGAGACT
ACACCACCGCAGCACAGTTG	GACGTGTCACTCTGTGTGTCTGTCACTG
ACACCACCGCAGCACAGTTG	GACGTGTCACTCTGTGTGTCTGTCACTG
ACACCTTGTCGCACATAGTA	unknown
ACACCTTGTCGGCTATATAA	GTGACACTGTCTCAGAGACTGACAGAGA
ACACCTTGTCGGCTATATAA	CGTGACACTGTCTCAGAGACT
ACACCTTGTCTATAGAAGCT	unknown
ACACGAGAATTCTTCATCTC	GTCTCTCAGTCAGAGACTCACACTCAGT
ACACGAGAATTGGACGTGAC	unknown
ACACGCCGAAACGTTGAATA	GTGTGTCTGTGTGTCTGTGTGACTGTGA
ACACGCCGAAACGTTGAATA	CGTGTGTCTGTGTGTCTGTGTGA
ACACGCCGAACGATCACGAT	CGTCTGTCTCTCTGTCAGAGTGTGTCTC
ACACGCCGAACGATCACGAT	GTGAGTCTGACTCTGTCTCTCTGACTGT
ACACGCCGAACGATCACGAT	GTCTGTCTCTCTGTCAGAGTGTGTCTCA
ACACGCCGAACGATCACGAT	TCGTCTGCCTCTCTGTCAGAGTGTGTCT
ACAGAACTTAGCAGGTATCC	unknown
ACAGAATGAACGATTGATAA	unknown
ACAGATCTATACATATGCGA	CGTCTGTCTCTCTGTCAGAGT
ACAGATCTATACCAAGCCAG	unknown
ACAGATCTATGTTAAGGTGA	unknown
ACAGATCTATTGTCAGGCAC	unknown
ACAGATTGTTACTGGTAAGA	unknown
ACAGGATAGAAGTCGTCCTA	CGTGTGTCTGTGTGTCTGTGTGAC
ACAGGATAGACTCTCCATAG	unknown
ACAGTTCATTGACGAAGACT	unknown
ACAGTTCATTTGCAAGATAC	unknown
ACATAAGTAACATCAATTAA	unknown
ACATAGGTGGTATCGCGCCA	CACTCAGAGAGTGACTGTGACT
ACATAGGTGGTCGCATCTTG	unknown
ACATATGCGAGCTCGGTATG	unknown
ACATCTTCACACATAGGTGG	CGTGTGTCTGTGTGTCT
ACATCTTCACCCGGTGGACA	GTGTGAGTGTGACTCTGAGAGACTCTCT
ACATGCCTGTCCGGTCACTA	CGTGTCTCAGTCAGAGACTCACA
ACATTAGATACATGCTGACT	unknown
ACATTAGATACGCCTCATCT	unknown
ACATTAGATAGCACTTCACG	CACTCTCACACTCTCTCTGT
ACATTAGATAGCACTTCACG	ACTCTCACACTCTCTCTGTCAGTCTCAG
ACATTAGATAGCACTTCACG	CACTCTCACACTCTCTCTGTCA
ACATTCTTATCGGACTGAGG	GTGAGTCTGACTCTGTCTCTCTTGAGAT
ACATTCTTATGTAGTTCTAG	unknown
ACATTCTTATTCCTGGTCGG	AGGACGTCTCTCAGTCAGAGACTCACAC
ACCAATAGCGCGACGGACGA	unknown
ACCAATTGTACATCAGTTGG	unknown
ACCAATTGTAGGCTTCGTCG	GTGAGTGACACAGTGTGAGAGTCTGTCA
ACCAATTGTAGGCTTCGTCG	CGTGAGTGACACAGTGTGAGAGT
ACCAGCGCATCTAGTGTAAC	GTCTCTCAGTCAGAGACTCACACTCAGT
ACCATCGGAAGTTGTCTGAC	GTCTCTCAGTCAGAGACTCACACTCAGT
ACCATCGGAAGTTGTCTGAC	GTCTCTCAGTCAGAGACTCACACTCAGT
ACCGACATTACTAAGATATT	unknown
ACCGACTTCGTAGTTAGACG	unknown
ACCGAGTTGCCCTTAAGGCT	GTGAGTGACACAGTGTGAGAGTCTGTCA
ACCGAGTTGCCCTTAAGGCT	GTCTCTCAGTCAGAGACTCACACTCAGT
ACCGAGTTGCCCTTAAGGCT	GTCTCTCAGTCAGAGACTCACACTCAGT
ACCGATGACGCGGACTGAGG	unknown
ACCGATGACGGCTTCTGTAC	unknown
ACCGATGACGTCCGTGAAGC	unknown
ACCGATGACGTCGATGCGCG	GTCTCTCAGTCAGAGACTCACACTCAGT
ACCGATGACGTGCGGTTACG	CGTCTCAGTGTCAGACACTGACAGAGTG
ACCGATGACGTGCGGTTACG	GTGAGTGAGTCTCAGTGACTCTCAGAGT
ACCGATGACGTGCGGTTACG	GTCTCAGTGTCAGACACTGACAGAGTGA
ACCGATGACGTTCAGTGCGG	unknown
ACCGCGGTAAGCGAATCGAC	unknown
ACCGCGGTAAGCTTAGTCGG	unknown
ACCTGATCCGTATGGCATAG	ACTCTCACACTCTCTCTGTCAGTCTCAG
ACCTGATCCGTATGGCATAG	ACTCTCACACTCTCTCTGTCAGTCTCAG
ACCTGATCCGTCTTGGAGAC	unknown
ACCTTAAGTTACATATGCGA	unknown
ACCTTAAGTTCTTACCGGTG	unknown
ACGACAATATGCACTTCACG	TCACACACTGAGACACACTCTGACACTG
ACGACAATATGCCGCAATAG	unknown
ACGACCGACGCCAGATTCGG	GTGTGTCTGTGTGTCTGTGTGACTGTGA
ACGACCGACGCCAGATTCGG	GTGTGTCTGTGTGTCTGTGTGACTGTGA
ACGACGGAGCAAGCGCCGTA	unknown
ACGACGGAGCTCCAATAGAA	unknown
ACGACGTCCAATTCCGCTCA	unknown
ACGAGGCCATCGAGGAGTCA	unknown
ACGAGGCCATCTCAACATGT	GTGAGTCTGACTCTGTCTCTCTGACTGT
ACGAGGCCATGTCACGTGCT	unknown
ACGAGGCCATTAACAGCCAA	unknown
ACGAGGCCATTCCAGGTACT	unknown
ACGAGGTGGAGCCAGCACGT	CGTGAGTGACACAGTGTGAGAGTCTGT
ACGAGGTGGAGCCAGCACGT	CGTGGGTGACACAGTGTGAGAGTCGGT
ACGAGTAGCTAATAATGCAC	GACTCAGAGTGTCTGTGACACACTCACA
ACGAGTAGCTCGGACTGAGG	GAGTGACTGTCAGTGTGAGAGTGTCAGA
ACGAGTAGCTCGGACTGAGG	CGAGTGACTGTCAGTGTGAGA
ACGAGTAGCTCTGCAGGATA	unknown
ACGAGTAGCTGCCGCAATAG	unknown
ACGATGATCGAAGTTGGAGG	unknown
ACGATGATCGCGATCACGAT	GAGAGTGTCAGTCTGACACACACTCTGA
ACGATGATCGCGATCACGAT	TGTTTCTGAGTCTGAGAGAGTCTGTCAG
ACGATGATCGGTAATTGACA	unknown
ACGATGCGAAGTTAAGGTGA	unknown
ACGATGTCGTCAACTCGTCG	unknown
ACGATTACCAGCTCAGCTGG	CTGACAGTGTGTGTCAGTGTCAG
ACGATTACCAGTTGTCTGAC	ACACTGAGACTCACACCTCTGTCTCAGT
ACGATTACCAGTTGTCTGAC	AGACTGAGACTCACACCTCTGTCTCAGT
ACGATTACCATCCAGGTACT	GTGTGAGTGTGACTCTGAGAGACTCCCT
ACGCAACTCTAGCAGGCAGC	unknown
ACGCAGAGGTCCTTACCACA	unknown
ACGCAGAGGTGACTGTTCCT	unknown
ACGCATAGTGTTGACATCTC	unknown
ACGCATTGCAAAGATCAATT	CACTCAGAGAGAGACTGTGACTCTGTC
ACGCCTCAGTACGGCGAGGC	unknown
ACGCCTCAGTTGACGTCCTT	GTGTGAGTGTGACTCTGAGAGACTCTCT
ACGCCTCAGTTGGAGCTCAG	GTGAGTCTGACTCTGTCTCTCTGACTGT
ACGGCACTCCTTCCACTACA	CGTCTCTCAGTCAGAGACTCACA
ACGGCCTGTAGGCTTCGTCG	GTGTGAGTGTGACTCTGAGAGACTCTCT
ACGGTACCTCAGGAGCTCCA	TCAGAGTCACTGTCACAGACTCTCAACT
ACGGTACCTCAGGAGCTCCA	TCAGAGTCACTGTCACAGACTCTCAACT
ACGGTACCTCAGGAGCTCCA	TCAGAGTCACTGTCACAGACTCTCAACT
ACGGTACCTCAGGAGCTCCA	CTCAGAGTCACTGTCACAGACT
ACGTAATCCTGCTGCTCTTC	unknown
ACGTAGATAAGTTGTTCTCT	unknown
ACGTAGCGCGCTGACCTGGT	GACTCAGAGTTACAGTCAGAGACTGTGA
ACGTATACAGAGTTCCTGTC	unknown
ACGTCCGCGTCACATGTTAC	unknown
ACGTCTTATACGCACTGGAT	unknown
ACGTCTTATAGTTACGCGTC	unknown
ACGTTAGCACGTAATACGTC	unknown
ACGTTAGCACTATATGCGTT	unknown
ACGTTCGCCAATCGGACAAG	unknown
ACGTTCGCCAGTAGTTCTAG	CACTCAGTGTGTGTCTGAGACTCA
ACGTTCTAGCAGCCTCCTAT	unknown
ACGTTCTAGCCAGTCCAGGA	GTGACACTGTCTCAGAGACTGACAGAGA
ACGTTCTAGCTTAATTGCTC	unknown
ACGTTGAATAAAGGAATGTA	unknown
ACGTTGAATACCTGCGAACA	GACGTGTCACTCTGTGTGTCTGTCACTG
ACGTTGAATACCTGCGAACA	GACGTGTCACTCTGTGTGTCTGTCACTG
ACGTTGTACGGGCACTGAGC	unknown
ACGTTGTACGTGGTATTGTC	unknown
ACTAACCGTACTCTGTCTCC	unknown
ACTAACCGTATAGTTGTCAC	unknown
ACTAACTTAACCGAGCGATT	GTCAGAGTGTGTGACACAGACAGTGACA
ACTAACTTAAGGCACTGAGC	GTGAGTCTGACTCTGTCTCTCTGACTGT
ACTAACTTAATCAGATAGAT	unknown
ACTACCGTGCGCTTAGTCGG	CGACTCAGAGTCACAGTCAGA
ACTACCGTGCTTGTGGCATC	unknown
ACTACGGTCGGATTCAGAGA	unknown
ACTACGGTCGGCCAGCACGT	unknown
ACTACTGCCACTAGACACTT	unknown
ACTACTGCCACTCACAGCGG	unknown
ACTACTGCCATGTATTCAGA	unknown
ACTGATCTCGAGTGTTGCTT	CGTCTGTCTCTCTGTCAGAGTGT
ACTGATCTCGTGGTATTGTC	CCGTCTCTCAGTCAGAGACTCACACTCA
ACTGCACAGGCAAGCCTTAG	unknown
ACTGCACAGGGTGCGAACAT	unknown
ACTTCAACACACGACTATTA	unknown
ACTTCAACACGATATAGCGG	GTGAGTGACACAGTGTGAGAGTCTGTCA
ACTTCAACACGATATAGCGG	CGTGAGTGACACAGTGT
ACTTCAACACGCCTCTGGCT	unknown
ACTTCAACACGTCGCGATTC	unknown
ACTTCGGATAAGTCTATCGT	GTGTGAGTGTGACTCTGAGAGACTCACT
ACTTCGGATAAGTCTATCGT	GTGTGAGTGTGACTCTGAGAGACTCTCT
ACTTCTATGCAGCGATCCAT	unknown
AGAACAGGTCGTTAAGGTGA	TCAGAGTCACTGTCACAGACTCTCAACT
AGAACAGGTCTGTGTGTAAC	unknown
AGAAGATATACTGCAGGATA	unknown
AGAAGATATAGCAGGTATCC	CGAGAGACTGTCACTGTCTCT
AGACCGATCGCATCGGCATG	unknown
AGACCGATCGGACCAGAATA	unknown
AGACCGATCGTCCAATAGAA	GTGTGAGTGTGACTCTGAGAGACTCTCT
AGACCGTCGTATCAGTTAAC	GTGTCTGTCTCAGACAGAGTGTCAGACA
AGACCGTCGTCATCGGCATG	unknown
AGACCGTCGTGTACATAGGC	unknown
AGACTGGAGCACAGTCCACC	unknown
AGACTGGAGCTGCTGCAGTA	unknown
AGAGACTCCGTATGAACAGC	unknown
AGAGACTCCGTTCTATCAGC	unknown
AGAGAGTCGCTCGTAGTCGT	unknown
AGAGCAGCGGGCACTTCACG	unknown
AGAGCCTAAGGCGCAGCACC	unknown
AGAGCCTAAGGTAACGACGC	unknown
AGAGCCTAAGTTGATCTTAA	unknown
AGAGCGGCAAGCGCAGCACC	unknown
AGAGCTGTAGCGGCGATACC	unknown
AGAGCTGTAGGTCGCGATTC	unknown
AGAGCTGTAGTACGGACTCT	unknown
AGATCAAGCTCGATATGTGC	unknown
AGATCGCCTAGTTGCGCCGG	unknown
AGATCTCTTGATTAACCGGC	GTGTGAGTGTGACTCTGAGAGACTCTCT
AGATCTCTTGGTAACGACGC	GTGACACTGTCTCAGTGACTGACAGAGA
AGATCTTGAGTACGAAGTGC	GTCTCTCAGTCAGAGACTCACACTCAGT
AGATCTTGAGTGTTCACTAG	unknown
AGATTAAGGACTTGTCTAGT	unknown
AGATTAAGGATCCAGGTACT	unknown
AGATTGAGAGATTAAGATAA	AGTCTCTGTGTGTCTGACACTCACAGTG
AGATTGAGAGATTAAGATAA	AGTCTCTGTGTGTCTGACACTCACAGTG
AGATTGAGAGCTGACCTGGT	unknown
AGATTGAGAGGGTGCAACCT	unknown
AGCAACATGAGTCGGACCTC	GTGACACACTCACTGTGTCTCACTCTGT
AGCACAGTTGCACCGCTAGT	unknown
AGCACAGTTGCTCGCAGGTC	unknown
AGCACAGTTGCTTGACTCAA	unknown
AGCAGCCACGATCGGACAAG	GTGAGTGAGTCTCAGTGACTCTCAGAGT
AGCAGCCACGATCGGACAAG	CGTGAGTGAGTCTCAGTGACT
AGCAGCCACGATCGGACAAG	GTGAGTGAGTCTCAGTGACTCTCAGAGT
AGCAGCCACGCTTCCATCCT	GAGTGTGACTGTGTCTCAGAGACTGAGA
AGCAGCCACGCTTCCATCCT	GAGTGTGACTGTGTCTCAGAGACTGAGA
AGCAGCCACGTATCATCTCT	GTCACACTGTCTCTGTCTCAGTCAGAGA
AGCATGTAACCATCAGTTGG	unknown
AGCATGTAACCGTCCGCTCT	unknown
AGCCACCATTAGTGGTGGTA	unknown
AGCCGCTCTATATAGAAGCT	GGACGTGTCACTCTGTGTGTCAAAA
AGCCGGACGCGTGCGAACAT	unknown
AGCCTCCTATAACCTTGCGG	GACACACTGACTGTGTGAGTCTCAGAGT
AGCCTCCTATCGATCACGAT	unknown
AGCGAACCTAGTGTGAAGTT	unknown
AGCGAGAGCTGCGCAGCACC	unknown
AGCGATCCATCCGGTGGACA	unknown
AGCGCTGGACCAGTCCAGGA	unknown
AGCGCTGGACGCTAGTAGAA	unknown
AGCTATGCTTAACAGCATAG	unknown
AGCTATGCTTGCGCAGCACC	unknown
AGCTCATCGCCGGACCACCT	GTGACTGTCAGTCTCTGAGGTCTGAGTC
AGCTCATCGCTATCATCTCT	unknown
AGCTGCTGAACTTGCCGCGC	unknown
AGCTTAGAGTGCTTCTGTAC	GTTTCTCAGTCAGAGACTCACACTCAGT
AGCTTAGAGTGCTTCTGTAC	GTCTCTCAGTCAGAGACTCACACTCAGT
AGCTTCCGGAAATTCGAAGG	ACTCAGAGAGTGACTGTGACTCTGTCTG
AGCTTCCGGACCGAGCGATT	unknown
AGGAACCACTCTTCCGATAA	unknown
AGGAACGGACCTGTGAGCAG	unknown
AGGACCTGGACGAGGAGTCA	unknown
AGGAGCACTGGCGAACACGG	GTGACTGTCAGTCTCTGAGGTCTGAGTC
AGGAGCACTGGCGAACACGG	GTGACTGTCAGTCTCTGAGGTCTGAGTC
AGGAGCTCCACTTGTCTAGT	unknown
AGGAGCTCCATACCATGACT	unknown
AGGATCTGCTACGTTGAATA	CGTGTGAGTGTGACTCTGAGAGAC
AGGATCTGCTGTAACGACGC	unknown
AGGATTCTACTTCTATCAGC	unknown
AGGCACTTGGAGAATTCAGT	GTGTGAGTGTGACTCTGAGAGACTCTCT
AGGCACTTGGAGAATTCAGT	GTGTGAGTGTGACTCTGAGAGACTCTCT
AGGCACTTGGAGAATTCAGT	CGTGTGAGTGTGACTCTGAGAGACTCTC
AGGCACTTGGAGAATTCAGT	GTGTGAGTGTGACTCTGAGAGACTCTCT
AGGCACTTGGATGGAAGGCC	unknown
AGGCACTTGGTCCTGGTCGG	unknown
AGGCACTTGGTGGAGCTCAG	unknown
AGGCAGTTCCGTCGTCGATC	GTATGAGTGTGACTCTGAGAGACTCTCT
AGGCATACTCCTCAACATGT	unknown
AGGCCAGTCGCAGGAACGAG	unknown
AGGCCAGTCGCATCAGTTGG	GACTCAGAGTGTCTGTGACACACTCACA
AGGCCAGTCGCTAAGAGTCC	unknown
AGGCCAGTCGGACTTACTCT	unknown
AGGCGCCATGAGGCACACCT	unknown
AGGCGCCATGCGTTCAATAA	GTCTGTCACACTGACAGTCAGTGTCTCT
AGGCTAGCTGAATGCCAGTT	unknown
AGGTATAGACCTCTAAGCAT	unknown
AGGTATAGACGCCTCTGGCT	unknown
AGGTCGCAACCCGGTGGACA	TGTGAGACAGTCACAGTGTGTCTGTCTG
AGGTCGCAACGATGGAGTGC	unknown
AGGTGTAAGCATATTCTCAC	unknown
AGGTGTAAGCTCGCATCTTG	GTGACACTGTCTCAGAGACTGACAGAGA
AGTAGTAATAACGACTATTA	unknown
AGTAGTAATAGTCGCGATTC	unknown
AGTCATTATTAAGTTGGAGG	unknown
AGTCCAACTGCTGCAGGATA	GTGTGAGTGTGACTCTGAGAGACTCTCT
AGTCCAACTGCTGCAGGATA	GTGTGAGTGTGACTCTGAGAGACTCACT
AGTCCAACTGCTGCAGGATA	CGTGTGAGTGTGACTCTG
AGTCCAGAGCACATCATTGC	unknown
AGTCCATCCAGTAGTTCTAG	GTGTGAGTGTGACTCTGAGAGACTCTCT
AGTCCATCCAGTAGTTCTAG	GTGTGAGTGTGACTCTGAGAGACTCTCT
AGTCCATCCATGGTATTGTC	CGTGTGAGTGTGACTCTGAGA
AGTCGACCATAGTCTATCGT	GGACGTGTCACTCTGTGTGTCTGTC
AGTCGACCATCGGACGGATT	unknown
AGTCGACCATGTCTCACAGT	unknown
AGTCGGCTTGAAGTCACGGC	TCAGTCACTGTCTGTGACTCAGTCTGTG
AGTCGGCTTGAAGTCACGGC	TCAGTCACTGTCTGTGACTCAGTCTGTG
AGTCGGTGAGCTTCGGCCGG	GTATCTGACTCAGTGAGTGTCGGTCACA
AGTCGGTGAGTTACTGCCTT	unknown
AGTCGGTGAGTTGTGGCATC	GTGTGAGTGTGACTCTGAGAGACTCTCT
AGTCGTCCTAATAACATACG	unknown
AGTCTATCGTGCCAGCTTCG	unknown
AGTGAAGAGTATAGCTGGAT	TGTCTCTGTGTCTGAGAGAGTCTGTCAG
AGTGAAGAGTGACCAGTACG	CGTCTCTGACTCAGTGAGTGT
AGTGAAGAGTGACCAGTACG	GTCTCTGACTCAGTGAGTGTCTGACACA
AGTGAAGAGTGACCAGTACG	CGTGTCTGACTCAGTGAGTGT
AGTGAAGAGTGGAGCAACAG	unknown
AGTGACCGGAGTGTCCATAC	unknown
AGTGCCGTTCGTTCGCGCGC	unknown
AGTGCCGTTCTTACTGCCTT	unknown
AGTGCTGTCTGTAATTGACA	unknown
AGTGGTGGTAGCAACTATTG	GTCTGACTCAGACTGTGTGTGTGTGTCT
AGTGTCTAGACATGGACTCC	unknown
AGTGTCTAGAGCGAATCGAC	unknown
AGTGTCTAGAGTGTCACGAG	ACTCTCACACTCTCTCTGTCAGTCTCAG
AGTGTGAATCGATGGAGTGC	CGACTCAGAGTTACAGTCAGAGACTGG
AGTGTTGTGATATTACTCTC	unknown
AGTTCACTCAAGCACAGTTG	CAGTGTGAGAGTCTGTGAGTCAGTGT
AGTTCACTCAAGCACAGTTG	CAGTGTGAGAGTCTGTGAGT
AGTTCACTCAGCAACTATTG	unknown
AGTTCCTGTCACTTCAACAC	unknown
AGTTCCTGTCGTGTCACGAG	unknown
AGTTCCTGTCTACTAATGGC	unknown
AGTTCTTGCTCTTACCGGTG	unknown
AGTTGACGTTGCCTCCGGTC	unknown
AGTTGACGTTGCTTAGTCGG	GTGTGTCTGTGTGTCTGTGTGACTGTGA
AGTTGCGATATACGGACTCT	unknown
AGTTGCGATATGACTTCGTA	unknown
AGTTGTCGAAAATACTCGAT	unknown
AGTTGTCGAATATCGCGCCA	unknown
AGTTGTTCGTCATTCCGGCT	unknown
AGTTGTTCGTCTAAGAGTCC	unknown
ATAAGCGGAGGCGCGCCGAG	GTGACTGTCTCACTCAGAGAGTCACTGA
ATAAGCGGAGGCGCGCCGAG	GACGTGACTGTCTCACTCAGAGAGTCAC
ATAAGCGGAGTGTCAGGCAC	GACGTGTCACTCTGTGTGTCTGTCACTG
ATACATGGACAACGAGTATT	unknown
ATACATGGACGCCAGCTTCG	unknown
ATACATGGACGCTCAGCTGG	unknown
ATACCACCTAACGACTATTA	unknown
ATACCGAGCTATCTCGCTGC	unknown
ATACCGAGCTCTCTAAGCAT	unknown
ATACCTCCATAAGTAAGCGT	unknown
ATACCTCCATAGATTGCTCA	unknown
ATACCTCCATGATATGGCAA	GTGACACTGTCTCAGAGACTGACAGAGA
ATACGGATTAACGTTGAATA	unknown
ATACGGATTATCAATGGTGG	unknown
ATACGTACTGAGCACAGTTG	unknown
ATACGTACTGTATTCATATA	unknown
ATACGTTCCAAGATTGAGAG	CTGTGAGACAGTCACAGTGT
ATACGTTCCAATAACATACG	GTGAGTGAGTCTCAGTGACTCTCAGAGT
ATACGTTCCAATAACATACG	CGTGAGTGAGTCTCAGTGGCT
ATACGTTCCATTCTCACTCC	unknown
ATACTCCTACCTGATACTTC	unknown
ATACTCTGTCAGACCGTCGT	GTGTGTCTCTCTGTCAGAGTGTGTCTCA
ATACTCTGTCAGACCGTCGT	GTCAGTCTCTCTGTCAGAGAGAGACTCA
ATACTCTGTCGGAACGTGCC	ACTCAGAGAGTGACTGTGACTCTGTCTG
ATACTCTGTCGGAACGTGCC	ACTCAGAGAGTGACTGTGACTCAGTCTG
ATACTGAGGAAATTCCAACC	CACTCTCACACTCTCTCTGTCAGTCTC
ATACTGAGGAAATTCCAACC	CACTCTCACACTCTCTCTGTCAGTCTC
ATACTGAGGAACATCATTGC	ACTCTCACACTCTCTCTGTCAGTCTCAG
ATAGCAGGTAATGTTCTATA	unknown
ATAGCTGGATTCGTAGTCGT	unknown
ATAGGAGTCTGACTCTCCAA	TGTGAGACAGTCACAGTGTGGCTGTCTG
ATATACGCCTAGTGTTGCTT	unknown
ATATACGCCTCATCAGTTGG	unknown
ATATACGCCTGTCGCGATTC	GTGTCTGTGACAGAGTGTGACTGACTCT
ATATATGCTCACATAGGTGG	unknown
ATATATGCTCGCTTCTGTAC	unknown
ATATCAATCGAAGTTCGACC	unknown
ATATCAATCGGACATCGGTG	CGTGACTGACTCCCACACTGTGTGAGA
ATATCAATCGTCAATGGTGG	GTCTGTCACACTGACAGTCAGTGTCTCT
ATATCCGAATGGCTATATAA	CGGCTCAGTGTCAGACACTGACAGAGTG
ATATCTCGTTCAACTCGTCG	unknown
ATATCTCGTTGTGTCCATAC	unknown
ATATCTCGTTTTCACTGGCG	unknown
ATATGATGCTCAAGCCTTAG	unknown
ATATTAACTGGCCAGCTTCG	unknown
ATATTAACTGTCTTGGAGAC	unknown
ATATTAACTGTGGATTAGAC	unknown
ATATTAGAGCGGAGCAACAG	unknown
ATATTAGAGCGTGGCAGGTG	unknown
ATCAGAGTCATGGATTAGAC	unknown
ATCAGTTAACAGTTGTCGAA	unknown
ATCAGTTAACCGCGAGTCGA	unknown
ATCATTCAGCGTCTACCTTC	GGACGTGTCACTCTGTGTGTCTGTCAC
ATCCACTAAGCGAGGTTAAC	unknown
ATCCTAATACGTCACGTGCT	CAGTGAGTGTCTGACTGTCTGACT
ATCCTAATACGTCACGTGCT	AGTGTGTGTCTGACTGTCTGACTCTGTG
ATCCTAATACTCCTCCTGGC	unknown
ATCCTCATCATACGAAGTGC	unknown
ATCCTGGAGTGGAGGTCCAA	GTGAGTGACACAGTGTGAGAGTCTGTCA
ATCGACATGCATCGGACAAG	unknown
ATCGACATGCCTGCAGGATA	unknown
ATCGACATGCGAAGACAGAC	GTGACTGACTCTCACACTGTGTGTGACA
ATCGACATGCGCGACAGTGT	GTCTCTCAGTCAGAGACTCACACTCAGT
ATCGACATGCGTGCGAACAT	unknown
ATCGAGATCGCCATAAGGAG	unknown
ATCGGACAAGACAGTCCACC	unknown
ATCGTATAGGATTAACCGGC	unknown
ATCGTATAGGCTTCTTCGTA	unknown
ATCGTCGCAGCGTCCGCTCT	TCAGAGTCACTGTCACAGACTCTCAACT
ATCGTCGCAGCTAGTGTAAC	unknown
ATCGTCGCAGGCGAACACGG	unknown
ATCGTCGCAGTCGCATCTTG	unknown
ATCTCAAGCCTATCATCTCT	unknown
ATCTCGCTGCGCGCAGCACC	TGTCTCTGTGTCTGAGAGAGTCTGTCAG
ATCTCGCTGCGTCGCGATTC	unknown
ATCTCGCTGCTGTCAGGCAC	GACGTGTCACTCTGTGTGTCTGTCACTG
ATCTGAGATGAGGTTAGGAG	TGTGAGACAGTCACAGTGTGTCTGTCTG
ATCTGAGATGAGGTTAGGAG	CGTGAGTGACACAGTGTGAGAGTCTGTC
ATCTGAGATGAGTCGTCCTA	CACTCAGAGAGTGACTGTGA
ATCTGAGATGCGTACCGCGA	unknown
ATCTGAGATGTAAGCGTGGC	ACTCTCACACTCTCTCTGTCAGTCTCAG
ATCTGAGATGTAAGCGTGGC	CACTCTCACACTCTCTCTGTCAGTCT
ATGACTATGCTAGTTGTCAC	unknown
ATGAGGCTACTTGAGCCTGA	ACTCTCACACTCTCTCTGTCAGTCTCAG
ATGATCACGTGGTGCAACCT	unknown
ATGATCACGTTGACTTCGTA	unknown
ATGATCTTCGGGACACTCTT	CGTGTGAGTGTGACTCTGAGAGACTCT
ATGATGTTGCAACGAGTATT	GTGAGTGTCACAGTGTGAGAGTCTGTCA
ATGCACTGGTCCTGCGAACA	GTGACACTGTCTCAGGGTCTGACAGAGA
ATGCACTGGTTTGACATCTC	unknown
ATGCGAGCGTATCAGAGTCA	unknown
ATGCGAGCGTGCGAATCGAC	CATGTGAGTGTGACTC
ATGCGCTAATCCGGTCACTA	GTGAGTGACACAGTGTGAGAGTCTGTCA
ATGCGCTAATGCAACTATTG	unknown
ATGCGCTAATGCACATAGTA	unknown
ATGCTCCAGTATTCCGCTCA	unknown
ATGCTCCAGTGATAATGATG	unknown
ATGCTCCAGTGTCGCGATTC	unknown
ATGGAACAATATGGAAGGCC	unknown
ATGGAACAATTCCGAAGATT	unknown
ATGGAAGGCCGATGGAGTGC	unknown
ATGGTACCGAATATTCTCAC	unknown
ATGGTACCGACGTTCAATAA	unknown
ATGGTACCGACTCACTGTAG	AACGAGAGACTGTCACTGTCTCTGACAC
ATGGTACCGAGCGTTAGATG	unknown
ATGGTATGATAATTAATCTG	unknown
ATGGTATGATACAGTCCACC	unknown
ATGGTTCTAAGGAGTACGTA	CGACACACTGACTGTGTGAGTCTCAGA
ATGTAAGATTGACCAGTACG	unknown
ATGTAAGATTGGTATCCTTA	GTGTGAGTGAGACTCTGAGAGACTCTCT
ATGTAAGATTTGGTATTGTC	GACTGACTGTGTGACTCTGAGACAGTCA
ATGTAATTCCGCGAACACGG	unknown
ATGTAATTCCGCTTAGTCGG	unknown
ATGTACTTAACGATTCCGGC	unknown
ATGTACTTAAGCCTCCGGTC	unknown
ATGTCCGTGCACATGCCTGT	unknown
ATGTCTGCCAACGGCGAGGC	GTCTCAGTGTCAGACACTGACAGAGTGA
ATGTCTGCCAACGGCGAGGC	GTGAGTGAGTCTCAGTGACTCTCAGAGT
ATGTTCTATATCCAGGTACT	unknown
ATTAACCGGCCCTTACCACA	ACTCAGAGAGTGACTGTGACTCTGTCTG
ATTAACCGGCCTCGCAGGTC	unknown
ATTAAGATAAAGTAGTAATA	AGTGTGAGAGTCTGTGAGTCAGTGTCTG
ATTAAGATAACGAGGAGTCA	CACTCAGAGAGTGACTGTGACTCTGT
ATTAAGCGCGAATAATGCAC	unknown
ATTAATACAGCCGTGCAACC	GTGACTGTCAGTCTCTGAGGTCTGAGTC
ATTAATACAGGGCTCCAAGC	unknown
ATTAATACAGGTAGACGGAG	unknown
ATTACATAATGTGCGAACAT	ACACTGAGACTCACACCTCTGTCTCAGT
ATTACATAATGTTCGCGCGC	unknown
ATTACCGCGTCTTCGGCCGG	GACTCAGAGTGTCTGTGACACACTCACA
ATTACCGCGTGAGGTGCCGC	unknown
ATTACTAACGGTTGGATCCT	unknown
ATTACTAACGTGTAAGAGCT	unknown
ATTAGTGGTCAGTCGACCAT	unknown
ATTAGTGGTCCCTGTGAAGT	unknown
ATTATAGCACAGGAGCTCCA	GTCTGTCACACTGACAGTCAGTGTCTCT
ATTATAGCACAGTCGTCCTA	unknown
ATTATAGCACGTAGTTCTAG	unknown
ATTATAGCACGTTCGCGCGC	GAGAGACTGTCACTGTCTCTGACACTGT
ATTATCTAGCAGTAGTAATA	unknown
ATTATCTAGCCGATAAGCAC	unknown
ATTATTGTGCGTTACGCGTC	unknown
ATTCACGGTGCTCAAGTCGC	unknown
ATTCATCAAGAAGTTGGAGG	unknown
ATTCATCAAGCACCGCTAGT	unknown
ATTCATCAAGGCGTACAACT	GTGTGAGTGTGACTCTGAGAGACTCTCT
ATTCCGAGAGGTCGGACCTC	unknown
ATTCCGAGAGTAGTTAGACG	unknown
ATTGCTGGCGATGTTCTATA	unknown
ATTGCTGGCGCGATAAGCAC	unknown
ATTGCTGGCGTGATGACGTA	unknown
ATTGGAGTAGTAGCTGCTAC	CGTGTGTCTGTGTGTCTGTGTGACTGT
ATTGGAGTAGTTAACGTAGG	CGACACACTGACTGTGTGAGTC
ATTGGCAACTACGAGGCCAT	GTGTGAGTGTGACTCTGAGAGACTCTCT
ATTGGTAATCCCGTGCAACC	unknown
ATTGGTAATCGCTGCTCTTC	unknown
CAACAGACAGCCACTGGATT	unknown
CAACAGACAGTTGTGGCATC	CGTCTCTCAGTCAGAGACTCACACTCAG
CAACCGTATATCAATGGTGG	CACTCTGAGAGTGTCTGTGACTCTG
CAACCGTATATCAATGGTGG	ACTCAGAGAGTGACTGTGACTCTGTCTG
CAACTCGTCGAAGTTCGACC	GTGTGAGTGTGACTCTGAGAGACTCCCT
CAAGAGGTCACTTCCGATAA	GTGAGTCTGACTCTGTCTCTCTGACTGT
CAAGATGCCGACGACAATAT	unknown
CAAGATGCCGCTCAACATGT	unknown
CAAGCTGAAGAAGTCACGGC	GTGTGAGTGTGACTCTGAGAGACTCTCT
CAAGCTGAAGAAGTCGATCC	GTGTGAGTGTGACTCTGAGTGTCTCTCT
CAATAGAGTGCGCCTCATCT	GTGACACTGTCTCAGAGACTGACAGAGA
CAATAGAGTGGCTCTCGGTT	unknown
CAATAGAGTGGGTTGGTAAC	unknown
CAATAGAGTGTGTGTGTAAC	CACTCAGAGAGTGACTGTGACTCTGT
CAATCCGGAGGCTGTGAGAC	unknown
CAATCCGGAGTAGCGCACGT	unknown
CAATCCGGAGTAGTTGTCAC	unknown
CAATCTCATGCTGCAGGATA	GGACGTGTCACTCTGTGTGTCTGTC
CACAACAAGAGCAGGTATCC	unknown
CACACTATACCATCAATTAA	GACTCAGAGTGACAGTCAGAGACTGTGA
CACACTATACGGTTGGTAAC	GTCAGAATGTGTGACACAGACAGTGACA
CACACTATACTCTCGCGACC	unknown
CACATGTTACAGTTCCTGTC	CGTGTCTGTCTCAGACAGAGT
CACATGTTACAGTTCCTGTC	TGTCAGTGTGTCTGTCTGTGAGTCTCAG
CACATGTTACTTGACATCTC	unknown
CACCGCTAGTGACCAGTACG	unknown
CACCGTGTGTAGCGATCCAT	GTGTGTCTGTGTGTCTGTGTGACTGTGA
CACCTAGGAAATGTCTGCCA	unknown
CACCTAGGAACTTGACTCAA	CGTCTGACTCAGACTGTGTGTGTGTGT
CACCTAGGAACTTGACTCAA	CGTCTGACTCAGACTGT
CACCTAGGAACTTGACTCAA	GTATGACTCAGACTGTGTGTGTGTGTCT
CACCTAGGAACTTGACTCAA	CGTCTGACTCAGACTGTGTGTGTGTGT
CACCTAGGAAGAGTAGATTG	GTGTGAGTGTGACTCTGAGAGACTCACT
CACCTAGGAATAGGCTCAGG	unknown
CACCTCCAATAAGGAATGTA	unknown
CACCTCCAATAATACTCGAT	GACTGTGTCACAGAGTCACAGTCTCTCT
CACCTCCAATCGACGGACGA	GACTCAGAGTCACAGTCAGAGACTGGGA
CACGCAAGTGAGTGGACACC	unknown
CACGCAAGTGAGTGGTGGTA	unknown
CACGCAAGTGCTTGCCGCGC	GTGACACTGTCTCAGAGACTGACAGAGA
CACGCAAGTGCTTGCCGCGC	GTGACACTGTCTCAGAGACTGACAGAGA
CACGCTCTCTGCCAGCTTCG	CGTGAGTGACACAGTGTGAGAGTCTGT
CACGGAGACCCATTCCGGCT	AGAGAGTCTCACTGTCAGTGACTGACTG
CACGGAGACCTTCTCCTGTA	unknown
CACGGATCGAACCTCTCCTG	CGTGAGTCTGACTCTGTCTCTCTG
CACGGTCGTACGAATATAGG	unknown
CACGGTCGTACGTCCGCTCT	ACTCAGAGAGTGACTGTGACTCTGTCTG
CACGGTCGTACTCGATTGGT	unknown
CACGTACCAAAGTTGTCGAA	unknown
CACGTACCAAATGTTCTATA	unknown
CACGTACCAATTCACTGGCG	unknown
CACTACTTGACACCGCTAGT	unknown
CACTATGAGAGACGAAGACT	ACTCTCACACTCTCTCTGTCAGTCTCAG
CACTATGAGAGATTCAGAGA	unknown
CACTATGAGAGTGCGAACAT	unknown
CACTCAGTCACTAAGATATT	unknown
CACTCTTAACTACGAAGTGC	CGACTCTGTGTCTCACTGTGAGAGTG
CACTGTGGAAATATTCTCAC	unknown
CACTTAGCTAAGGCACACCT	unknown
CAGAATCTTCCTCGATTGGT	unknown
CAGAATCTTCTTCTATCAGC	GTGACACTGTCTCAGAGACTGACAGAGA
CAGAGCGTGCATGATCATTA	CGTGAGTCTGACTCTGTCTCT
CAGAGTGCCACACCGAGCAT	GTGACACTGTCTCAGAGACTGACAGAGA
CAGAGTGCCACACCGAGCAT	CGTGACACTGTCTCAGAGACTGA
CAGAGTGCCACACCGAGCAT	GTGACACTGTCTCAGAGACTGACAGAGA
CAGAGTGCCAGTGTCACGAG	unknown
CAGATCGGTCATACTCCTAC	GTGTGAGTGTGACTCTGAGAGACTCTCT
CAGATCGGTCGCGCGCCGAG	GTGTGAGTGTGACTCTGAGAGACTCTCT
CAGATCGGTCGTAGACGGAG	unknown
CAGATCGGTCGTGTGAAGTT	TGTCTCTGTGTCTGAGAGAGTCTGTCAG
CAGATTCAACAGTGGTGGTA	unknown
CAGCCAGACGCGGCGATACC	GAGTGACTGTCAGTGTGAGAGTGTCAGA
CAGCCAGACGCGGCGATACC	TTGAGGACGAGTGACTGTCAGTGTGAGG
CAGCCGTCACCGCCTCTCGG	CGTGAGTGACACAGTGTGAGAGT
CAGCCGTCACCGCCTCTCGG	GAGACGTGAGTGACACAGT
CAGCCGTCACGCAGGTATCC	ACTCAGAGAGTGACTGTGACTCTGTCTG
CAGCCGTCACGCAGGTATCC	ACTCAGAGAGTGACTGTGACTCTGTCTG
CAGCGAAGTCAAGATTAACC	unknown
CAGCGCTGAGGGACACTCTT	unknown
CAGCGCTGAGTACGGACTCT	unknown
CAGCTAATGCACAGTTCATT	unknown
CAGGCGTACTCTTCCTACAG	CGTCTCTCAGTCAGAGACTCACACTCAG
CAGGTATAAGGCGCGCCGAG	CACTCAGAGAGTGACTGTGACTCTGT
CAGGTATAAGTATTACTCTC	GACTCAGAGTGTCTGTGACACACTCACA
CAGGTGTAGACTAGGCCACG	CGTGTGAGTGTGACTCTGAGAGAC
CAGGTGTAGATTCTCCTGTA	unknown
CAGTAAGGTGCTAAGAGTCC	unknown
CAGTAAGGTGCTCACCTAAG	unknown
CAGTAAGGTGGGAGCAACAG	CGTCTGTCTCTCTGTCAGAGTGT
CAGTAAGGTGGGAGCAACAG	GTATGTCTCTCTGTCAGAGTGTGTCTCA
CAGTAAGGTGGGAGCAACAG	GTGTGTCTCTCTGTCAGAGTGTGTCTCA
CATAAGCACTGTCTACCTTC	unknown
CATACATGAGGTTGGATCCT	unknown
CATACATGAGTCATCGGATT	unknown
CATACCAGTCGATTGATGGC	unknown
CATACCAGTCTACGCCGATT	unknown
CATACCAGTCTGACTTCGTA	GTGACTGGCAGTCTCTGAGGTCTGAGTC
CATACCAGTCTGTGTGTAAC	AGTCACTGAGTGTGACTCTGTGACTGAG
CATACGCCATCAACTCGTCG	unknown
CATACGCCATCGAGGAGTCA	unknown
CATACGCCATGCGCGCCGAG	GTGTGTCTGTGTGTCTGTGTGACTGTGA
CATAGAATATATCTCGCTGC	unknown
CATAGAATATCTGATACTTC	unknown
CATAGAATATGCGCGCCGAG	CGTCTGTCTCTCTGTCAGAGTGTG
CATAGCGACGATGGCGTGCG	unknown
CATAGCGACGATGTTCTATA	unknown
CATAGCGACGCGGACTGAGG	unknown
CATAGCGACGCTTCGGCCGG	ACTCTCACACTCTCTCTGTCAGTCTCAG
CATAGCGACGGTCGTCGATC	unknown
CATAGGACTGCGATTGATAA	unknown
CATAGTATTAACTTCAACAC	unknown
CATAGTATTACTGCAGGATA	unknown
CATCAATTAACGGCAGAGTC	unknown
CATCAATTAACTCTGTCTCC	unknown
CATCAATTAATCTGTTCATA	unknown
CATCAATTAATGCTCAGAAG	GTCTCTCAGTCAGAGACTCACACTCAGT
CATCACTTCCCAATCTCATG	CGTGACACTGTCTCAGAGACTGACAGA
CATCACTTCCCATGCTGACT	unknown
CATCACTTCCGTTACGCGTC	GTGTGTCTCAGACAGACTGTCTGTCTGT
CATCACTTCCGTTACGCGTC	GTGTGTCTCAGACAGACTGTCTGTCTGT
CATCACTTCCGTTACGCGTC	GTGTCTCTCTGACTGACTCTGTGTGTGT
CATCATCGATTAACAGCCAA	unknown
CATCATGACCATAGAGAGCC	CACTCTCACACTCTCTCTGT
CATCATGACCATAGAGAGCC	ACTCTCACACTCTCTCTGTCAGTCTCAG
CATCATGACCCTCAACATGT	unknown
CATCATTCGACATGCTGACT	unknown
CATCATTCGACGCGACGAGG	CACTCAGAGAGTGACTGTGACTCTGT
CATCATTCGAGGAGTACGTA	GTGTGTCTGTGTGTCTGTGTGACTGTGA
CATCATTCGAGGAGTACGTA	AACGTGTGTCTGTGTGTCTGTGTGACTG
CATCCTGCACCTAGACACTT	unknown
CATCCTGCACTGTATTCAGA	unknown
CATCGGCATGGTAACGACGC	GTGTGAGTGTGTCTCTGAGAGGCTCTCT
CATCGGCATGTCATCGGATT	unknown
CATCGTCAGTTCTTCATCTC	CGTGTGAGTGTGACTCTGAGAGACTCA
CATCTATATATGTAAGAGCT	unknown
CATCTCGTATCTTCGATGGT	unknown
CATCTCGTATGAGTAGATTG	GTCTGACTCAGTCTGTGTGTGTGTGTCT
CATGAAGTGTTAACATAGCA	unknown
CATGGCAGCGTGACTTCGTA	unknown
CATGGCTGTACGAGGAGTCA	GTGAGTCTGACTCTGTCTCTCTGACTGT
CATGTCTTGATACGCCGATT	GTGTGTCTGTGTGTCTGTGTGACTGTGA
CATTATCCTTATTAAGATAA	CGTGTGAGTGTGACTCTGAGAGA
CATTCACACAACGTTGAATA	ACTCAGAGAGTGACTGAGACTCTGTCTG
CATTCACACACTAAGAGTCC	GTGTGAGTGTGACTCTGAGAGACTCTCT
CATTCACACAGTAATTGACA	unknown
CATTCCGGCTAAGATCAATT	unknown
CATTCCGGCTGCAACAGAAC	TGTCAGTGTGTCTGTCTGTGAGTCTCCG
CATTGTTATAAGTGTTGCTT	unknown
CCAATAGGCATGTCAGGCAC	unknown
CCAATCGGACTGGTATTGTC	unknown
CCAATTCATCATATTCTCAC	unknown
CCAATTCATCTACGTTATGG	unknown
CCACAGGTATAACAGCATAG	unknown
CCACAGGTATGGTGCAACCT	unknown
CCACGCTGTGTATCGGAATA	unknown
CCAGAATTAGTCTCGCGACC	unknown
CCAGAGTTGACTAGTGTAAC	unknown
CCAGATATCTATCAGTTAAC	unknown
CCAGATATCTTGCAGTGGTA	unknown
CCAGATTCGGCGATTGATAA	unknown
CCATAAGGAGTTGACATCTC	unknown
CCATGAGAGGCGACGGACGA	TCAGAGTCACTGTCACAGACTCTCAACT
CCATGAGAGGCGACGGACGA	TCAGAGTCACTGTCACAGACTCTCAACT
CCGAATCAGTACCAATCTAA	unknown
CCGAATCAGTCTCTGTCTCC	unknown
CCGAATCAGTTCTGTTCATA	unknown
CCGACTTGCAAAGATCAATT	GTGTCTGTGACAGAGTGTGACTGACTCT
CCGACTTGCAGGCTTCGTCG	unknown
CCGAGATTAAAGTCGACCAT	unknown
CCGAGCGATTGACTGTTCCT	unknown
CCGAGTGACCTGACTTCGTA	CAGTGTGAGAGTCTGTGAGTCAGTGTC
CCGAGTTCGACTCACTGTAG	unknown
CCGAGTTCGATACGCCGATT	GACTCAGAGTGTCTGTGACACACTCACA
CCGATGAGCACAGTGTATGC	GTGTCTCTCTGACTGACTCTGTGTGTGT
CCGATGAGCACGGACTGAGG	ACTCAGTGTGTGTCTGAGACTCACAGAG
CCGATGAGCATTGAGCCTGA	CGTGAGTCTGACTCTGTCTCTCTG
CCGATGAGCATTGAGCCTGA	GTGAGTCTGTCTCTGTCTCTCTGCCTGC
CCGATTCCAAAAGTCGATCC	CGTGTGAGTGTGACTCTGAGAGACTCT
CCGATTCCAAAAGTCGATCC	CGTGTGAGTGTGACTCTGAGAGACTCT
CCGATTCCAAAAGTCGATCC	TGTCTCTGTGTCTGAGAGAGTCTGTCAG
CCGCAGACTGCGTACCGCGA	GTGACACTGTCTCAGAGACTGACAGAGA
CCGCAGACTGCGTACCGCGA	TCGTCTGTCTCTCTGTCAGAGTGTGTCT
CCGCAGACTGGCCGGTTGTA	GTGACTGTCTCACTCAGAGAGTCACTGA
CCGCAGACTGGCCGGTTGTA	CGTGACTGTCTCACTCAGA
CCGCAGACTGGCCGGTTGTA	CGTGCCTGTCTCACTCAGAGAGTCACT
CCGCAGACTGTGATGACGTA	unknown
CCGCATACGTGACTTACTCT	GTGAGTGACACAGTGTGAGAGTCTGTCA
CCGCATACGTTATTACTCTC	GTATGTCTCTCTGTCAGAGTGTGTCTCA
CCGCGGCACTTATAGAAGCT	unknown
CCGGCAATACACGTTGAATA	unknown
CCGGCAATACGCTCGGTATG	GTGCAGTCACAGTGTGACACTGTCTGTG
CCGGCAATACGCTCGGTATG	GTGCAGTCACAGTGTGACACTGTCTGTG
CCGGTCACTAAGGTTAGGAG	unknown
CCGGTCACTACATCAATTAA	unknown
CCGGTCACTAGACCAGAATA	CACTCAGAGAGTGACTGTGACT
CCGGTCTCCGAAGTTGGAGG	ACTCAGAGAGTGACTGTGACTCTGTCTG
CCGGTCTCCGCTTGTCTAGT	unknown
CCGGTCTCCGGTCGGACCTC	unknown
CCGGTCTCCGTAACAGCCAA	unknown
CCGGTCTCCGTTGATATTCC	CGTGAGTGAGTCTCAGTGACT
CCGGTCTCCGTTGATATTCC	GTGAGTGAGTCTCAGTGACTCTCAGAGT
CCGGTGGACACGGACGGATT	GTGAGTGACACAGTGTGAGAGTCTGTCA
CCGGTGGACACGGCAGAGTC	ACACTGAGACTCACACCTCTGTCTCAGT
CCGTAGCTCAACGACTATTA	unknown
CCGTCCGGTGGCACTTCACG	CAGTGAGTGTCTGACTGTCT
CCGTCCGGTGGCACTTCACG	AGTGAGTGTCTGACTGTCTGACTCTGTG
CCGTCCGGTGTAGTTGTCAC	unknown
CCTAGAGCAGATAGAGAGCC	unknown
CCTAGTGTGGACATAGGTGG	GTCTGTCTGTGTGTCTGTGTGACTGTGA
CCTAGTGTGGCGTATTGCTC	unknown
CCTAGTGTGGTTGACATCTC	GTCGTATGTCACTCTGTC
CCTATTGGTGGTCAGTACCA	unknown
CCTATTGGTGGTCTCACAGT	GTGAGTCTGACTCTGTCTCTCTGACTGT
CCTCAGGTCGAGACCGTCGT	unknown
CCTCATGCCAGGCACTGAGC	unknown
CCTCCAGATTACGACGTCCA	GACTGTGAGTCACTCACTGTCACTCTCT
CCTCCAGATTATGGAAGGCC	unknown
CCTCGTTGACAGTGGACACC	CGTGTGAGTGTGACTCTGAGAGAC
CCTCGTTGACAGTGGACACC	GTGTGAGTGTGACTCTGAGAGACTCTCT
CCTCGTTGACCCAGATTCGG	AGTCTCGGTGTGTCTGACACTCACAGTG
CCTCGTTGACCCAGATTCGG	CAGTCTCTGTGTGTCTG
CCTGATATAGAGAATTCAGT	unknown
CCTGATCGCAAATTCCAACC	unknown
CCTGATCGCAAGTCTATCGT	unknown
CCTGATCGCAATGCGAGCGT	TTTCTATTAAAAAAAAAAAAAAAAAAAA
CCTGATCGCAATGCGAGCGT	GTGAGTGACACAGTGTGAGAGTCTGTCA
CCTGATCGCAATGCGAGCGT	GTGAGTGACACAGTGTGAGAGTCTGTCA
CCTGATCGCAATGCGAGCGT	GTGAGTGACACAGTGTGAGAGTCTGTCA
CCTGATCGCAATGCGAGCGT	TTTCCATTAAAAAAAAAAAAAAAAAAAA
CCTGCCGCTAATAACATACG	GTGTGAGTGTGACTCTGAGAGACTCTCT
CCTGCCGCTACACCGAGCAT	GTGTGAGTGTGACTCTGAGAGACTCTCT
CCTGCCGCTACAGTGTATGC	unknown
CCTGCCGCTATCGCATCTTG	unknown
CCTGCTTAGTAGACTTACGT	unknown
CCTGTCGTCACTTCTTCGTA	unknown
CCTGTTAATGAAGATTAACC	unknown
CCTGTTAATGTATCGCGCCA	GTGAGTGAGTCTCAGTGACTCTCAGAGT
CCTGTTGCGCAGAGAGTCGC	unknown
CCTGTTGCGCCCTTAAGGCT	unknown
CCTTAAGGCTGATGAGAGGT	unknown
CCTTACCACATCTTCATCTC	unknown
CCTTGACGGCCGCTGAATTC	unknown
CCTTGACGGCTAACATAGCA	unknown
CGAAGGCAGACGGACTGAGG	GTGTGAGTGTGACTCTGAGAGACTCTCT
CGAAGGCAGACGGACTGAGG	GTGTGAGTGTGACTCTGAGAGACTCTCT
CGAAGGCAGAGCGAACACGG	unknown
CGAATCGCAGACCAATCTAA	unknown
CGACCACTGAATCAGTTAAC	TCAGAGTCACTGTCACAGACTCTCAACT
CGACCACTGAGATATAGCGG	GCGTGAGTGTGACTCTGAGAGACTCTCT
CGACCTTGGTATGTTCTATA	unknown
CGACGCTCTCAGTGTTGCTT	unknown
CGACGGACGATCCGAAGATT	unknown
CGACGGACGATTCTCACTCC	unknown
CGACTACTCTGACTTACTCT	GTGTGAGTGTGACTCTGAGAGACTCTCT
CGACTACTCTTTGATATTCC	unknown
CGACTTAGTGATCGAGCGAA	unknown
CGACTTAGTGATTCCGCTCA	unknown
CGACTTAGTGCTTCCGATAA	GTGTGAGTGTGACTCTGAGAGACTCTCT
CGAGCAGGTTAATTCCAACC	unknown
CGAGCAGGTTCAAGAGGTCA	unknown
CGAGCTGGAAATACTGAGGA	unknown
CGAGCTGGAACAACTCGTCG	unknown
CGAGCTGGAACATCAGTTGG	unknown
CGAGCTGGAAGGAGGTTGGT	CGACTCAGAGTGTCTGTGACACA
CGAGTTCAGCTCTAATGACG	unknown
CGATACGCCAAAGGATTGAT	unknown
CGATACGCCAAGCACAGTTG	unknown
CGATACTAGCCTCGCAGGTC	unknown
CGATACTAGCCTTCAATAAT	unknown
CGATAGAATAATGATCATTA	unknown
CGATAGAATAGTGTCCATAC	unknown
CGATAGTACGAGGCACACCT	unknown
CGATAGTACGGCACATAGTA	unknown
CGATCACGATCCATCGTGAC	unknown
CGATCACGATGACGAAGACT	unknown
CGATCACGATGGCCTGCACA	unknown
CGATCACGATTTGATATTCC	unknown
CGATGAAGTGGTCGCGATTC	CAGTCACTGAGTGTGACTCTGTGACT
CGATGAAGTGTAGAAGACTC	unknown
CGATGAAGTGTCCGACCGTA	unknown
CGATGCTGACAGACTTACGT	unknown
CGATTGATAACGTACCGCGA	GTCTCTCAGTCAGAGACTCACACTCAGT
CGATTGATAACGTACCGCGA	GTCTCTCAGTCAGAGACTCACACTCAGT
CGATTGATAACGTACCGCGA	GTCTCTCAGTCAGAGACTCACACTCAGT
CGATTGCGCGAGTTCCTGTC	unknown
CGATTGCGCGCGGACGGATT	unknown
CGATTGCGCGCTGACCTGGT	unknown
CGATTGCGCGGGCTATATAA	AGAGAGTCGCACTGTCAGTGACTGACTG
CGATTGCGCGTCCGACCGTA	unknown
CGCAATCCACATGCGAGCGT	GTGCAGTCACAGTGTGACACTGTCTGTG
CGCAATCCACCCAGATTCGG	TGAGTGAGTGTCTGAGTCTGTCTCTCAG
CGCACAGGTAAGTGGTGGTA	unknown
CGCACAGGTACTCTGTCTCC	CTCAGAGTCACTGTCACAGACT
CGCACAGGTACTCTGTCTCC	GCCTCAGAGTCACTGTCACAGACTCTCA
CGCACAGGTACTCTGTCTCC	TCAGAGTCACTGTCACAGACTCTCAACT
CGCACAGGTAGCCTCTGGCT	unknown
CGCACAGGTATCTGTTCATA	unknown
CGCACTCACCCATGCTGACT	unknown
CGCACTCACCCGCCTCATCT	unknown
CGCACTCACCGCACTTCACG	ACTCTCACACTCTCTCTGTCAGTCTCAG
CGCACTCACCGCACTTCACG	CACTCTCACACTCTCTCTGTCA
CGCACTCACCGCTCGGTATG	GTGAGTGAGTCTCAGTGACTCTCAGAGT
CGCACTGGATTCTAATGACG	unknown
CGCCTCATCTGCGACAGTGT	unknown
CGCCTCTCGGGTGTCCATAC	unknown
CGCCTGGAGAAGAATTCAGT	CGTCTGTCACACTGACAGTCAGTGTCT
CGCCTGGAGAAGAATTCAGT	GTCTCTGACTCAGTGAGTGTCTGACACA
CGCCTGGAGACACCGAGCAT	unknown
CGCCTGGAGAGAGGTGCCGC	GTGAGTGACACAGTGTGAGAGTCAGGCA
CGCCTGGAGATCGATGCGCG	AGTCTCTGTGTGTCTGACACTCACAGTG
CGCGAATCAGGTTAAGGTGA	unknown
CGCGACGAGGCTGTGAGCAG	unknown
CGCGACGAGGTGCTGCAGTA	TCACACACTGAGACACACTCTGACACTG
CGCGACGAGGTGCTGCAGTA	GAGACCTCACACACTGAGACACACTCT
CGCGACGAGGTGCTGCAGTA	TCACACACTGAGACACACTCTGACACTG
CGCGAGCGATAGTGTTGCTT	unknown
CGCGAGCGATATGGCGTGCG	unknown
CGCGAGCGATGCTCAGCTGG	unknown
CGCGAGGACCTGCAGTGGTA	unknown
CGCGAGTCGACCTTACCACA	GTGACTGTCAGTCTCTGAGGTCTGAGTC
CGCGAGTCGACCTTACCACA	GTGACTGTCAGTCTCTGAGGTCTGAGTC
CGCGATACCTACAGTCCACC	GACGTGTCACTCTGTGTGTCTGTCACTG
CGCGATACCTACAGTCCACC	GACGTGTCACTCTGTGTGTCTGTCACTG
CGCGATACCTATACTGAGGA	unknown
CGCGCATACGCTCACTGTAG	unknown
CGCGTGTAATTATGGCATAG	unknown
CGCTCGCCTCTCTTGGAGAC	TGTCTCTGTGTCTGAGAGAGTCTGTCAG
CGCTGCCGTGACATGCCTGT	unknown
CGCTGCCGTGTGACGTCCTT	unknown
CGGACCACCTCTATCACTAG	unknown
CGGACCACCTGGTTGGTAAC	CGTGTGAGTGTGACTCTGAGAGACT
CGGACCTTGGATCCACTAAG	GACTCAGAGTGTCTGTGACACACTCACA
CGGACCTTGGCCTGCTTAGT	GTGTGAGTGTGACTCTGAGAGACTCTCT
CGGACCTTGGCCTGCTTAGT	CGTGTGAGTGTGACTCTGAGAGACTC
CGGACCTTGGCCTGCTTAGT	GTGTGAGTGTGACTCTGAGAGACTCTCT
CGGACCTTGGGTATTGGCTA	unknown
CGGACGGATTCCATCGTGAC	unknown
CGGACGGATTGGTGCAACCT	unknown
CGGACGTTCCATGACGGATA	unknown
CGGACGTTCCCATCGGCATG	GTGTGTCTCAGACAGACTGTCTGTCTGT
CGGACGTTCCCATCGGCATG	TGTGTCTCTCTGACTGACTCTGTGTGTG
CGGACGTTCCCGCACTGGAT	unknown
CGGACGTTCCTGGAGCTCAG	unknown
CGGCAGAGTCGGAGCTATGG	unknown
CGGCCTCATCCACTCAGTCA	ACTCTCACACTCTCTCTGTCAGTCTCAG
CGGCCTCATCGACTCTCCAA	unknown
CGGCGAGCGACCAGATTCGG	CGTGAGTCTGACTCTGTCTCTCT
CGGCGAGCGACCAGATTCGG	CGTGAGTCTGACTCTGTCTCT
CGGCGAGCGACCAGATTCGG	CGTGAGTCTGACTCTGTCTCTCTGACT
CGGCGAGCGACCAGATTCGG	GTCGTGAGTCTGACTCTGTCTCT
CGGCGAGCGATTAATTGCTC	AGTGTGAGAGTCTGTGAGTCAGTGTCTG
CGGCGATACCAGATTGCTCA	unknown
CGGCGTGTAATCTAATGACG	unknown
CGGTAAGATAGCTAGTAGAA	unknown
CGGTAGACACATCTCGCTGC	unknown
CGGTAGACACGCTTAGTCGG	unknown
CGGTCCGCTCAGACTTACGT	GTGTGAGTGTGACTCTGAGAGACTCTCT
CGGTCGAACCTGCGGTTACG	unknown
CGTACCGCGAGACCGTCTCT	unknown
CGTACTTATTAGTAGTTACG	unknown
CGTACTTATTGGTTGGTAAC	GTGAGTCTGACTCTGTCTCTCTGACTGT
CGTACTTATTGGTTGGTAAC	GTGAGTCTGACTCTGTCTCTCTGACTGT
CGTAGACACTGTTACCACAT	GTGTGAGTGTGACTCAGAGAGACACTCT
CGTAGACACTTGATGACGTA	unknown
CGTATCGCCTATATTCTCAC	GTGTGAGTGTGACTCTGAGAGACTCTCT
CGTATCGCCTGCACATAGTA	unknown
CGTATGAATTAGATTGAGAG	unknown
CGTATGAATTGCGTACAACT	unknown
CGTATTGCTCTAACAGCCAA	ACTCTCACACTCTCTCTGTCAGTCTCAG
CGTCAACATGAGAATTCAGT	unknown
CGTCAACATGGTATTGGCTA	unknown
CGTCAACATGTAGGCTCAGG	GACACACTGACTGTGTGAGTCTCAGAGT
CGTCCGCTCTATGACGGATA	unknown
CGTCCGCTCTTAACATAGCA	unknown
CGTCGTTCAGCAAGAGGTCA	CGTGAGTGACACAGTGTGAGAGTCTGT
CGTCTCAGACCTTGCCGCGC	GTGAGTGACACAGTGTGAGAGTCTGTCA
CGTCTCAGACGTACATAGGC	unknown
CGTCTGCTGAAGCCTCCTAT	unknown
CGTCTGCTGAAGGTTAGGAG	unknown
CGTCTGCTGAGTAATTGACA	unknown
CGTCTGCTGAGTGTCCATAC	unknown
CGTGGCAACACGAGGTTAAC	unknown
CGTTCAATAAAACGAGGTCC	GCGTCTCTCAGTCAGAGACTCACACTCA
CGTTCAATAACGCGACGAGG	CGTCACACTGTCTCTGTCTCAGTCAG
CGTTCAATAACGCGACGAGG	CGTCACACTGTCTCTGTCT
CGTTCAATAAGCAGGTATCC	unknown
CGTTCTACGAACGGCGAGGC	GTCTCTCAGTCAGAGACTCACACTCAGT
CGTTCTACGAACGGCGAGGC	TCGTCTCTCAGTCAGTGACGCACACTCA
CGTTCTACGACTCTGTCTCC	unknown
CGTTCTACGAGACCAGTACG	unknown
CGTTGGTGGTTGATGACGTA	GTGACACTGTCTCAGAGACTGACAGAGA
CTAAGAGTCCAACAGCATAG	GTGTGTGTGAGTGTGTGACTGTGTCTGA
CTAAGAGTCCAATTCCAACC	unknown
CTAAGAGTCCGAGGTGCCGC	unknown
CTAAGATATTAGTGTTGCTT	unknown
CTAAGCGTAAAATCAGTGGA	unknown
CTAAGCGTAAACATAGGTGG	CGGCTCTGTGTCTCACTGTGAG
CTAAGCGTAAAGATTGCTCA	unknown
CTACAATACGACATATGCGA	unknown
CTACAATACGACTACGGTCG	unknown
CTACCGGACCCCTGCTTAGT	unknown
CTACCGGACCGTTGTTCTCT	unknown
CTACTAATAATGACGTCCTT	CGACTCAGAGTGTCTGTGACACAC
CTACTCATCCCTTCCATCCT	unknown
CTACTGATGGCTTACCGGTG	unknown
CTAGACACTTGGCCTGCACA	unknown
CTAGACACTTGTAATTGACA	unknown
CTAGCGGCATTACGTTATGG	unknown
CTATCAAGCACGCCTCTCGG	unknown
CTATCAAGCAGCTCTCGGTT	unknown
CTATCAAGCATTGTGGCATC	unknown
CTATCGCCTTCTATCACTAG	unknown
CTATCGCCTTGCCAGCTTCG	GTGAGTCTGACTCTGTCTCTCTGACTGT
CTATGAACGAACATCATTGC	unknown
CTATGAACGAATGGAAGGCC	unknown
CTATGAACGACCTGTGAAGT	CGTGAGTGACACAGTGTGAGAGTCTGT
CTATGAACGACCTGTGAAGT	GTGAGTGACACAGTGTGAGAGTCGGTCA
CTATGAACGATGACGTCCTT	unknown
CTATGTATAAGACTGTTCCT	TGTCAGTGTGTCTGTCTGTGAGTCTCTG
CTATGTATAAGCACATAGTA	unknown
CTATGTATAATCCGACCGTA	unknown
CTATGTATAATGTGTGTAAC	CGTGTGAGTGTGACTCTGAGAGACTCTC
CTCAACATGTGTTGTCTGAC	GACTCAGAGTGTCTGTGACACACTCACA
CTCAAGGACATACTAATGGC	ACTCAGAGAGTGACTGTGACTCTGTCTG
CTCAAGTCGCAGTTCCTGTC	unknown
CTCACTGTAGCAGTGTATGC	unknown
CTCACTGTAGCTGTGAGCAG	unknown
CTCAGAGGCGCAATCTCATG	CTGTCAGTGTGTCTGTCTGTGAGTCTC
CTCAGAGGCGTGCTCAGAAG	CGTGTGAGTGTGACTCTGAGAGACT
CTCCACCATAACGACGTCCA	GTCACACACTCACTGAGTGTCAGTGACA
CTCCACCATAACGACGTCCA	GTGCAGTCTCAGTGTGACACTGTCTGTG
CTCCACCATAATCGGACAAG	unknown
CTCCTCCTAACGTATTGCTC	CGTGTGACTGTCAGTGTGAGAGTGTCA
CTCCTCTGTATATGAACAGC	unknown
CTCCTGAGGCCGTATCGCCT	unknown
CTCGAACCTTAAGGATTGAT	unknown
CTCGAACCTTCTAGGCCACG	unknown
CTCGAGAGCACGAGGTTAAC	GTGTGAGTGTGACTCTGAGAGACTCTCT
CTCGAGCTAGCTGATACTTC	unknown
CTCGAGCTAGGCCAGCTTCG	unknown
CTCGCAGGTCCACTCAGTCA	unknown
CTCGGCGTATTCCAGGTACT	unknown
CTCGGTTAATGCCAGCTTCG	unknown
CTCTAAGCATAAGCGCCGTA	unknown
CTCTAAGCATGGCTATATAA	unknown
CTCTATGCTAAACGAGTATT	unknown
CTCTATGCTACGATATGTGC	ACTCTCACACTCTCTCTGTCAGTCTCAG
CTCTATGTGTCGGCAGAGTC	GACTCTGTGTCTCACTGTCAGAGTGACT
CTCTATGTGTTCTTCATCTC	unknown
CTCTATGTGTTTCGTAGCAC	AGAGAGTCTCACTGTCAGTGACTGACTG
CTCTCACGACCGTACCGCGA	GTCTCTCAGTCAGAGACTCACACTCAGT
CTCTCACGACCGTACCGCGA	GTCTCTCAGTCAGAGACTCACACTCAGT
CTCTCACGACCGTACCGCGA	TAACTAGGGAACCCACTGCTTAAGCCTC
CTCTCACGACCGTACCGCGA	CGTCTCTCAGTCAGAGACTCACACTCA
CTCTCACGACGATTCAGAGA	unknown
CTCTCACGACTATCGGAATA	unknown
CTCTCACGACTGTTCACTAG	unknown
CTCTCCATAGACTTCAACAC	unknown
CTCTTCTCAAAAGATTAACC	unknown
CTCTTCTCAAAGAGCGGCAA	unknown
CTCTTCTCAAATAACATACG	GGGACAGTCAGTCTCTGAGGTCTGCGTC
CTCTTCTCAAATTAAGATAA	unknown
CTGAACCACACCGAGCGATT	TCAGAGTCACTGTCACAGACTCTCAACT
CTGAACCACACCGAGCGATT	TCAGAGTCACTGTCACAGACTCTCAACT
CTGAACCACACCGAGCGATT	TCAGAGTCACTGTCACAGACTCTCAACT
CTGAACCACACCGAGCGATT	TCAGAGTCACTGTCACAGACTCACAACT
CTGAACCACACCGAGCGATT	TCAGAGTCACTGTCACAGACTCTCAACT
CTGAACCACACCGAGCGATT	TCAGAGTCACTGTCACAGACTCTCAACT
CTGAACCACACTTCCGATAA	unknown
CTGACCTGGTATACTGAGGA	unknown
CTGACCTGGTCTTCAATAAT	GACGTGTCACTCTGTGTGTCTGTCACTG
CTGACCTGGTCTTCAATAAT	GACGTGTCACTCTGTGTGTCTGTCACTG
CTGACCTGGTCTTCAATAAT	GACGTGTCACTCTGTGTGTCTGTCACTG
CTGAGCATGGGACTCTCCAA	unknown
CTGAGGATCCCACTCAGTCA	GAGTGACTGTCAGTGTGAGAGTGTCAGA
CTGATACTTCGTCGCGATTC	GTCTCTGAGTCTGAGTCTGTCTGTAACT
CTGATACTTCTCAATGGTGG	unknown
CTGATACTTCTGTCAGGCAC	unknown
CTGCACTCTGTAAGCGTGGC	GTATCTGACTCAGTGAGTGTCTGACACA
CTGCAGGATAGTGGCAGGTG	unknown
CTGCTAGTGGGCAACAGAAC	unknown
CTGCTAGTGGTTGACATCTC	unknown
CTGGATTAAGAGACCGTCGT	unknown
CTGGATTAAGCTGACCTGGT	unknown
CTGGATTAAGGAGTAGATTG	unknown
CTGGATTAAGTCATCGGATT	unknown
CTGGATTAAGTTCTCACTCC	GACGTGTCACTCTGTGTGTCTGTCACTG
CTGGCAACATTAACATAGCA	unknown
CTGGCTACTAACGCCTCAGT	unknown
CTGGCTACTAATTACCGCGT	unknown
CTGGCTATGTCTAAGAGTCC	ACTCAGAGAGTGACTGAGACTCTGTCTG
CTGGCTATGTCTAAGAGTCC	ACTCAGAGAGTGACTGAGACTCTGTCTG
CTGGCTATGTGAGACAACGG	unknown
CTGGCTATGTTGAGGTGGTT	unknown
CTGGTGTTGTATCGAGCGAA	unknown
CTGGTGTTGTCGCGACGAGG	GTGTGAGTGTGACTCTGAGAGACTCTCT
CTGGTTCGAGAGATTGCTCA	unknown
CTGTGAGCAGCGGCAGAGTC	CGTGAGTGACACAGTGTGAGA
CTTAAGCTCAGCTCTCGGTT	unknown
CTTACCGGTGAGTTCCTGTC	unknown
CTTACCGGTGGATATAGCGG	unknown
CTTCACGTTAATGGCGTGCG	CGACTCAGAGTCACAGTCAGAGA
CTTCATAACGTGCAGTGGTA	unknown
CTTCCAATGGACATATGCGA	unknown
CTTCCAATGGACGACTATTA	unknown
CTTCCAATGGAGTCGTCCTA	CACTCAGAGAGTGACTGTGACTCTGTC
CTTCCAATGGGAACGAATTC	unknown
CTTCCAATGGGAGGTGCCGC	GTGTGAGTGTGACTCTGAGAGACTCTCT
CTTCCAATGGGAGGTGCCGC	GTGTGAGTGTGACTCTGAGAGACTCTCT
CTTCCAATGGGAGGTGCCGC	GTGTGAGTGTGACTCTGCGAGACTCTCT
CTTCCAATGGGAGGTGCCGC	CGTGTGAGTGTGACTCTGAGAGACTCT
CTTCCAATGGGCCTCCGGTC	unknown
CTTCCATCCTAACGAGTATT	GTCTCTCAGTCAGAGACTCACACTCAGT
CTTCCATCCTCGATATGTGC	unknown
CTTCCATCCTTACGAAGTGC	unknown
CTTCCGATAAAGATTGAGAG	unknown
CTTCCGCGCGAATTCGAAGG	ACTCTCACACTCTCTCTGTCAGTCTCAG
CTTCCGCGCGAATTCGAAGG	GTGTGAGTGTGACTCTGAGAGACTCTCT
CTTCCGCGCGGTTAAGGTGA	unknown
CTTCCTACAGCCAGATTCGG	CACTCTCACACTCTCTCTGTC
CTTCCTACAGCCAGATTCGG	ACTCTCACACTCTCTCTGTCAGTCTCAG
CTTCCTACAGCCAGATTCGG	AGTGTCACAGAGAGTCTCTGACTCAGAG
CTTCGACCAACGATTGATAA	unknown
CTTCGATGGTCTCACAGCGG	CACTCTCACACTCTCTCTGTCA
CTTCGGCCGGAATTCGAAGG	ACTCTCACACTCTCTCTGTCAGTCTCAG
CTTCGGCCGGCCATCGTGAC	CACTCAGAGAGTGACT
CTTCTATCGAACGGTACCTC	ACTCTCACACTCTCTCTATCAGTCTCAG
CTTCTTCGTAAGCGATCCAT	unknown
CTTCTTCGTACACCGAGCAT	unknown
CTTGAAGAGACTCGATTGGT	unknown
CTTGAAGAGAGCGACAGTGT	GTCTGTCTCTCTGTCAGAGTGTGTCTCA
CTTGAAGAGAGCGACAGTGT	CGTCTGTCTCTCTGTCAGAGTGTGTCTC
CTTGACCGGTATAACATACG	unknown
CTTGACCGGTCGCTGAATTC	unknown
CTTGAGGAAGATATTCTCAC	unknown
CTTGCCGCGCATTAAGATAA	unknown
CTTGCCGCGCGATATAGCGG	unknown
CTTGGCGGCCACGACTATTA	unknown
CTTGGTGGTTATTAAGATAA	unknown
CTTGGTGGTTCTGACCTGGT	GAGTGACTGTCAGTGTGAGAGTGTCAGA
CTTGGTGGTTGATTCAGAGA	unknown
CTTGTAGCATGTTCGCGCGC	unknown
CTTGTTGTGTGCGTACAACT	unknown
CTTGTTGTGTTACAGTACGC	unknown
GAACCGCCTCCCGGTGGACA	unknown
GAACCGCCTCTCTGTTCATA	GTGAGTGAGTCTCAGTGACTCTCAGAGT
GAACGTGAAGCTTGTCTAGT	unknown
GAACTGCTCCAGTAGTAATA	unknown
GAAGAATGTGCTAGACACTT	GTGTGAGTGTGACTCTGAGAGACTCTCT
GAAGAATGTGTAGAAGACTC	unknown
GAAGAATGTGTCGCATCTTG	unknown
GAAGAATGTGTTCACTGGCG	CGTGTGGGTGTGACTCTGG
GAAGACAGACACAGTCCACC	unknown
GAAGACAGACCTTACCGGTG	ACTCAGAGAGTGACTGTGACTCTGTCTG
GAAGACAGACCTTGTCTAGT	unknown
GAAGAGCCTTCATCAGTTGG	unknown
GAATCCACTTCAGTCCAGGA	unknown
GAATCCATGAAGCGATCCAT	unknown
GAATCCATGACACCGAGCAT	unknown
GAATCGGACTCCACTGGATT	unknown
GAATGTAGGCAATTCCAACC	unknown
GAATGTAGGCATACTCCTAC	unknown
GAATGTAGGCGATGAGAGGT	unknown
GAATGTAGGCGTCGTCGATC	unknown
GAATTAGAAGATAACATACG	unknown
GAATTAGAAGCTCTCCATAG	GTCTCTCAGTCAGAGACTCACACTCAGT
GAATTAGAAGTTGATATTCC	unknown
GAATTCTCGGACAGTTCATT	unknown
GAATTCTCGGTCAGATAGAT	unknown
GACAAGCCTAAATTAATCTG	unknown
GACAAGCCTATTCCACTACA	unknown
GACAATTGAGCAATCTCATG	GGACGGGTCACTCTGTGTGTCTG
GACAATTGAGCAATCTCATG	GACGTGTCACTCTGTGTGTCTGTCACTG
GACATCGGTGCAAGCCTTAG	unknown
GACATCGGTGGACTGTTCCT	unknown
GACATTCAAGTGACTTCGTA	CGTGTGTCTGTGTGTCTG
GACATTCAAGTGACTTCGTA	ACTCAGAGAGTGACTGTGACTCTGTCTG
GACCAGAATACATCAATTAA	unknown
GACCAGAATAGACTTACTCT	GAGTGACTGTCAGTGTGAGAGTGTCAGA
GACCAGTACGCGATACTAGC	unknown
GACCATGTGCACGTTGAATA	GAGAGACTGCCACTGTCTCTGACACTGT
GACCATGTGCCGTTCTACGA	GTCTCTGACTCAGTGAGTGTCTGACACA
GACCATGTGCGTCAGTACCA	CACTCTCACACTCTCTCT
GACCGTCTCTAGCCTCCTAT	GACGTGTCACTCTGTGTGTCTGTCACTG
GACCTAATGGCCGAATCAGT	unknown
GACCTAATGGCTCACTGTAG	unknown
GACCTGATAAAGTCGACCAT	unknown
GACCTGATAAATGGCGTGCG	unknown
GACCTGCGCGACGGCGAGGC	unknown
GACCTGCGCGGGTTGGTAAC	GACGTGTCACTCTGTGTGTCTGTCACTG
GACGAAGACTTCCGTGAAGC	unknown
GACGCCTAGTATGGAAGGCC	unknown
GACGCGGTTGACACACCAGA	GACTCAGAGTGTCTGTGACACACTCACA
GACGCGGTTGACACACCAGA	CGTGTCTCTGACTGTCTGTGTGACTG
GACGCGGTTGGAGGTGCCGC	unknown
GACGCGGTTGTATCGGAATA	unknown
GACGCTGCTAGCCTCCGGTC	unknown
GACGTATAACCGGACTGAGG	TGTGAGACTGTGTGAGAGTGAGACTCAG
GACGTATAACTAGGCTCAGG	GACGTGTCACTCTGTGTGTCTGTCACTG
GACGTATAACTAGGCTCAGG	GACGTGTCACTCTGTGTGTCTGTCACTG
GACGTCAATGTGACGTCCTT	GTGTGTCTCAGACAGACTGTCTGTCTGT
GACGTCAATGTGACGTCCTT	GTGTCTCTCTGACTGACTCTGTGTGTGT
GACGTCTACAGGAGGTTGGT	unknown
GACGTGGCCGTTAATTGCTC	GACTCTGTGTCTCACTGTGAGAGTGACT
GACGTGGCCGTTAATTGCTC	GACTCTGTGTCTCACTGTGAGAGTGACT
GACTCACCTTGAAGACAGAC	unknown
GACTCACCTTTCATCGGATT	unknown
GACTCGAGCAACCAATCTAA	unknown
GACTCGAGCAGGCTTCGTCG	unknown
GACTCTCCAAGGACACTCTT	GAGAGACTGTCACTGTCTCTGACACTGT
GACTGCTCTCTTGTGGCATC	GTGTGAGTGTGACTCTGAGAGACTCTCT
GACTGTTCCTGTGAACGAGA	unknown
GACTTACTCTACATCATTGC	unknown
GACTTACTCTTATGGCATAG	unknown
GAGAACGCTAGCTCAGCTGG	unknown
GAGAACGCTAGTAATACGTC	unknown
GAGAACGTGTTACGCCGATT	unknown
GAGAATTAGTATTAAGATAA	unknown
GAGAATTAGTCAATCTCATG	unknown
GAGACATTCTACATGCCTGT	unknown
GAGAGATGTAGGCCTGCACA	unknown
GAGAGATGTAGTTGCGCCGG	GTGACTGTCTCACTCAGAGAGTCACTGA
GAGAGATGTAGTTGCGCCGG	CGTGTGTCTGTGTGTC
GAGAGATGTAGTTGCGCCGG	GTGTGTCTGTGTGTCTGTGTGACTGTGA
GAGAGCCTCCCAGCAAGCAG	unknown
GAGATTCGGTGCTAGTAGAA	unknown
GAGATTCGGTGCTGTGAGAC	GTGTGAGTGTGACTCTGAGAGACTCTCT
GAGCGGTACTAGCCTCCTAT	unknown
GAGCGGTACTCTTCCGATAA	unknown
GAGCGGTACTTTAACGTAGG	unknown
GAGGCAAGTCATGATCATTA	unknown
GAGGCAAGTCCACATGTTAC	CACTCAGAGAGTGACT
GAGGCAAGTCCGAGGAGTCA	unknown
GAGGCAAGTCGCCAGCTTCG	CGACACACTGACTGTGTGAGTCT
GAGGCAAGTCTCAGATAGAT	unknown
GAGGCCTGAGGCGTACAACT	unknown
GAGGTGCCGCGTACATAGGC	unknown
GAGTAGATTGACAGTTCATT	unknown
GAGTAGTTCAACCAAGCCAG	unknown
GAGTAGTTCAGCTAGTAGAA	unknown
GAGTAGTTCAGTAATACGTC	unknown
GAGTATATGTGTCGCGATTC	unknown
GAGTATTCCGACATATGCGA	ACTCAGAGAGTGACTGTGACTCTGTCTG
GAGTATTCCGTGCTGCAGTA	unknown
GAGTCCGTAGAGACTTACGT	unknown
GATAACATCAATGATCATTA	unknown
GATAAGGAGTCCATAAGGAG	unknown
GATAATACGCCCGTGCAACC	GTGACTGTCAGTCTCTGAGGTCTGAGTC
GATAATACGCTATCATCTCT	unknown
GATAGGCACCAACAGCATAG	unknown
GATAGGCACCATGACGGATA	unknown
GATAGGCACCGCGAATCGAC	GTGTGAGTGTGACTCTGAGAGACTCTCT
GATAGGCACCTAGTCGGAAT	unknown
GATATAGCGGCTCTAAGCAT	TGTGAGTGTGTGACTCTGTCTCTCACTG
GATATAGCGGCTTGTCTAGT	CCCTCAGTCACTGTCTGTGACTCAGTCT
GATATGGCAAGAGACAACGG	unknown
GATATGGCAAGCCGCAATAG	GTGTCTCTCAGAAAAAAAAAAAAAAAAA
GATATGGCAAGCCGCAATAG	GTGTCTCTCTGACTGACTCTGTGTGTGT
GATATTGTAGGATATGGCAA	GTCTGTCTCTCTGTCAGAGTGTGTCTCA
GATCATCAGCCTTCCGATAA	CGTCTGTCTCTCTGTCAGAGTGTGTCTC
GATCATCAGCCTTCCGATAA	CGTCTGTCTCTCTGTCAGAGTGTG
GATCATCAGCCTTCCGATAA	GTCTGTCTCTCTGTCAGAGTGTGTCTCA
GATCCACTCCGCACATAGTA	CGACTCAGAGTCACAGTCAGAGACTG
GATCCGAGGCCGAGGAGTCA	unknown
GATCGTCGACAATTAATCTG	unknown
GATGAACTCTCTAGACACTT	unknown
GATGAGAGGTAGCAGGCAGC	ACTCTCACACTCTCTCTGTCAGTCTCAG
GATGAGAGGTCGGCAGAGTC	unknown
GATTACAATGACAGTCCACC	unknown
GATTACAATGTAGTTGTCAC	unknown
GATTACAATGTCTAATGACG	GTGACACTGTCTCAGAGACTGACAGAGA
GATTACGCGCGTCGGACCTC	CACTCAGAGAGTGACTG
GATTACGCGCGTCGGACCTC	CACTCAGAGAGTGACTGT
GATTACGCGCTATCGCGCCA	unknown
GATTACTACAACGTTGAATA	unknown
GATTCAGAGAAGAATTCAGT	TGTGAGACAGTCACAGTGTGTCTGTCTG
GATTCAGAGAAGCAAGCGAC	unknown
GATTCAGAGACAGGAACGAG	unknown
GATTCGGAAGGACTTACTCT	ACTCAGAGAGTGACTGTGACTCTGTCTG
GATTGATGGCCTCTCCATAG	GTGACACTGTCTCAGAGACTGACAGAGA
GATTGATGGCCTCTCCATAG	GTGACACTGTCTCAGAGACTGACAGAGA
GCAACACGCTAACTTGCACC	GTCTGTCTCTCTGTCAGAGTGTGTCTCA
GCAACCTCGCCTTACCGGTG	CGTCTCTCAGTCAGAGACTCACACTCA
GCAACGACTACTAAGATATT	GTGAGTGACACAGTGTGAGAGTCTGTCA
GCAACTATTGACGACTATTA	GTGTGAGTGTGACTCTGAGAGACTCTCT
GCAACTATTGACGACTATTA	GTGTGAGTGTGACTCTGAGAGACTCTCT
GCAACTATTGACGACTATTA	CGTGTGAGTGTGACTCT
GCAACTATTGACGGCCTGTA	unknown
GCAAGACCGTCACATGTTAC	CGTGAGTGAGTCTCAGTGACTCTCAGAG
GCAAGACCGTCAGTCCAGGA	unknown
GCAAGACCGTTCGATGCGCG	unknown
GCAAGATGAACTTGTCTAGT	unknown
GCAAGATGAATACCATGACT	GTGACACTGTCTCAGAGACTGACAGAGA
GCAAGATGAATACCATGACT	GTGACACTGTCTCAGAGACTGACAGAGA
GCAAGATGAATGCAAGATAC	GTGTGTCTCTCTGTCAGAGTGTGTCTCA
GCAAGATGAATGCGGTTACG	CGTCACACTGTCTCTGTCTCAGTCAGAG
GCAAGTCTATGCCAGCTTCG	unknown
GCAATGATCAAGCCTCCTAT	CGTGTGTGACACAGTGTGAGAGTCTG
GCAATGATCAATGATCATTA	CAGTCACTGAGTGTGACTCTGT
GCAATGCGAGACTGGTAAGA	unknown
GCAATGCGAGGGCTATATAA	unknown
GCAATGCGAGTTCGCATAAT	CGTCTGTCTCTCTGTCAGAGTGTGTCTC
GCAATGCGAGTTCGCATAAT	GTGACAGTGTGAGACAGTCTCACAGTCT
GCAATGCGAGTTCGCATAAT	CTGTGAGTCAGTCACAGTGTGTCTGT
GCAATTACCGAGTCGACCAT	TCAGTCACTGTCTGTGACTCAGTCTGTG
GCAATTACCGCGATAAGCAC	GACTCAGAGTCACAGTCAGAGACTGTGA
GCAATTACCGCTAGACACTT	GTGAGTGACACAGTGTGAGAGTCCGTCA
GCAATTACCGGATAATGATG	unknown
GCACATAGTACGCACTGGAT	TCAGAGTCACTGTCACAGACTCTCAACT
GCACATTGCGATTAACCGGC	unknown
GCACATTGCGCTTCGATGGT	unknown
GCAGCAAGACATCGAGCGAA	CGTGAGTCTGACTCTG
GCAGCAAGACCCTTACCACA	unknown
GCAGCCTGTGCGTTCGATGG	unknown
GCAGCCTGTGTAACAGCCAA	unknown
GCATATACAAACATATGCGA	unknown
GCATATACAAAGCGATCCAT	unknown
GCATATACAAGAGTAGATTG	unknown
GCATCCGTTGGCCGGTTGTA	unknown
GCATCCGTTGGGAGCAACAG	unknown
GCATTGGCGCGCAGGTATCC	CGAGAGACTGTCACTGTCTCTGACACT
GCATTGGCGCGTCTCACAGT	unknown
GCATTGTACACATGCTGACT	unknown
GCCAAGCATCAACTTGCACC	CGTGACTGTCAGTCTCTGAGGTCTGAGT
GCCAAGCATCCTCTCCATAG	GTGTGAGTGTGACTCTGAGAGACTCTCT
GCCAAGCATCCTCTCCATAG	CGTGTGAGTGTGACTCTGAGA
GCCAAGCATCGCTCTCGGTT	unknown
GCCACCAGCTAGTGGTGGTA	GTGTGAGTGTGACTCTGAGAGACTCTCT
GCCACCAGCTGTTAAGGTGA	unknown
GCCACTAGTCGAGTAGATTG	GTCTGTCACACTGACAGTCAGTGTCTCT
GCCAGCACGTAACGAGGTCC	unknown
GCCAGCACGTACGACGTCCA	GTGTGAGTGTGACTCTGAGAGACTCTCT
GCCAGCACGTCTCTAAGCAT	ACTCAGAGAGTGACTGTGACTCTGTCTG
GCCAGCACGTCTTCCATCCT	unknown
GCCAGCATTACTTCGATGGT	unknown
GCCAGGTTGCACGTTGAATA	unknown
GCCAGGTTGCATACTCCTAC	unknown
GCCAGTGACGCATGCTGACT	ACTCAGAGAGTGACTGTGACTCTGTCTG
GCCAGTGACGCATGCTGACT	CACTCAGAGAGTGACTGTGACTCTGT
GCCAGTGACGCATGCTGACT	ACTCAGAGAGTGACTGTGACTCTGTCTG
GCCAGTGACGGTTACGCGTC	unknown
GCCAGTGACGTATCGGAATA	unknown
GCCATGTGTCTTCACTGGCG	unknown
GCCGAATAGTATCAGTTAAC	GTGTGAGTGTGACTCTGAGAGACTCTCT
GCCGAATAGTATCAGTTAAC	CGTGTGAGTGTGACTCTGAGAGACTCT
GCCGACGCATCCGTGCAACC	unknown
GCCGCAATAGATATTCTCAC	unknown
GCCGCAATAGGACGAAGACT	unknown
GCCGCGACTTACGGCCTGTA	unknown
GCCGCGATGAAGATTGAGAG	GTGTGAGTCACTGTCAGAGTGACTGTCT
GCCGGACCGAGATAATGATG	unknown
GCCGGACCGAGCTCAGCTGG	unknown
GCCGGTTGTACGGACTGAGG	unknown
GCCGGTTGTACTCACCTAAG	unknown
GCCGGTTGTAGTGGCAGGTG	unknown
GCCGGTTGTATCGCATCTTG	unknown
GCCGTACGGTAGCGATCCAT	ACTCTCACACTCTCTCTGTCAGTCTCAG
GCCGTACGGTTTGATCTTAA	CACTCAGAGAGTGACTGTGACTCT
GCCGTACGGTTTGATCTTAA	ACTCAGAGAGTGTCTGTGACTCTGTCTG
GCCTACCTGAAATCAGTGGA	unknown
GCCTACCTGAACGTTGAATA	GTGACTGTCTCACTCAGAGAGTCACTGA
GCCTACCTGAGCCGGTTGTA	unknown
GCCTCCGGTCGTGAACGAGA	unknown
GCCTCCGGTCTCCTGGTCGG	unknown
GCCTCTGGCTAATAATGCAC	unknown
GCCTCTGGCTAGGCACACCT	unknown
GCCTGAGTATCGAGGAGTCA	GTCTCTCAGTCAGAGACTCACACTCAGT
GCCTGAGTATCGAGGAGTCA	CGTCTCTCAGTCAGAGACTCA
GCCTGAGTATCGTATTGCTC	unknown
GCCTGTGCGTGACTATCACA	unknown
GCGAACACGGAAGTTGGAGG	unknown
GCGAACGATCCCGAATCAGT	CGTGAGTGACACAGTGTGAGAGTCTGTC
GCGAACGATCGTAATACGTC	unknown
GCGAACGATCTTGAAGAAGC	CACTCAGAGAGTGACTGTGACTCCG
GCGAACGATCTTGAAGAAGC	ACTCAGAGAGTGACTGTGACTCTGTCTG
GCGAATCGACGCTTAGTCGG	TGTGAGACAGTCACAGTGTGTCTGTCTG
GCGAATCGACTGTTCCAGAC	unknown
GCGAATGACTCCTGCTTAGT	GTGTCAGTGTCAGACACTGACAGAGTGA
GCGACAGTGTTTCTCACTCC	unknown
GCGATCGTACATTACCGCGT	unknown
GCGCACCAGGCTCAAGTCGC	unknown
GCGCACCAGGTCCAGGTACT	unknown
GCGCAGCACCAGAGAGTCGC	GTATGTCTCTCTGTCAGAGTGTGTCTCA
GCGCAGCACCAGAGAGTCGC	CGTCTGTCTCTCTGTCAGAGTGTGTCTC
GCGCAGCACCGTGTGAAGTT	GTCTCTGACTCAGTGAGTGTCTGACACA
GCGCCTAGCCCGCACTGGAT	unknown
GCGCCTAGCCGATGAGAGGT	unknown
GCGCGCCGAGTCGTAGTCGT	unknown
GCGCGCCGAGTGTTCACTAG	unknown
GCGCGTACGCGGTGCAACCT	unknown
GCGCGTGATGAGCAAGCGAC	CGTGAGTGACACAGTGTGAGAGTCTGTC
GCGCGTGATGCCTTACCACA	CTGTGAGACAGTCACAGTGT
GCGCGTGATGGAAGACAGAC	CGGGACTGTCAGTCTCTGAGGTCTGAGT
GCGCGTGATGGAAGACAGAC	GTGACTGTCAGTCTCTGAGGTCTGAGTC
GCGCGTGATGGAAGACAGAC	GTCTCTCAGTCAGAGACTCACACTCAGT
GCGGAACTTGCCATAAGGAG	unknown
GCGGAGCCATGATGAGAGGT	unknown
GCGGAGCCATGGAGCAACAG	GTCTGTCTCTCTGTCAGAGTGTGTCTCA
GCGGAGTGGACCATCGTGAC	unknown
GCGGAGTGGATAGTCGGAAT	unknown
GCGGAGTGGATGTTCCAGAC	GTGCAGTCACAGTGTGACACTGTCTGTG
GCGGTACAAGCCTGCTTAGT	GTGACACTGTCTCAGAGACTGACAGAGA
GCGGTACAAGGATTGATGGC	GTGAGTGAGTCTCAGTGACTCTCAGAGT
GCGGTGCAGACTCGCAGGTC	GTGTGAGTGTGACTCTGAGAGACTCTCT
GCGGTGCAGAGCGAATCGAC	unknown
GCGTAAGTAGCAAGCCTTAG	GTGTGAGTGTGACTCTGAGAGACTCTCT
GCGTAAGTAGCAAGCCTTAG	GTGTGAGTGTGACTCTGAGAGACTCTCT
GCGTAAGTAGGTGGCAGGTG	GAGAGACTGTCACTGTCTCTGACACTGT
GCGTAAGTAGGTGGCAGGTG	GTGAGTGACACAGTGTGAGAGTCTGTCA
GCGTAAGTAGGTGGCAGGTG	CGAGAGACTGTCACTGTCTCAGACACT
GCGTAGGCTTCGTATCGCCT	unknown
GCGTATAATCATTACCGCGT	unknown
GCGTATAATCCATATTAGGA	unknown
GCGTATGCGGATAGAGAGCC	GTGAGTGACACAGTGTGAGAGTCTGTCA
GCGTTAACGCCATCGGCATG	unknown
GCGTTAACGCCGCCTCTCGG	GTGAGTCTGACTCCGTCTCTCTGACTGT
GCGTTAGATGACACACCAGA	ACTCAGAGAGTGACTGTGACTCTGTCTG
GCGTTAGATGATGTTCTATA	GTGTCTGTCTCAGACAGAGTGTCAGACA
GCGTTAGATGCTAGTGTAAC	unknown
GCGTTAGATGTAGCGCACGT	unknown
GCGTTAGATGTGGACGTGAC	unknown
GCTAAGGTTCAAGTTGGAGG	unknown
GCTAAGGTTCAGTGGACACC	GTGAGTGAGTCTCAGTGACTCTCAGAGT
GCTAAGGTTCAGTGGACACC	GTGAGTGAGTCTCAGTGACTCTCAGAGT
GCTACCATACCGGACTGAGG	unknown
GCTACCATACGTATTGGCTA	unknown
GCTAGAAGTTCCAGATTCGG	CGACAGAGTCACTGAGTGAG
GCTAGTCTCGATGTCTGCCA	ACTCAGAGAGTGACTGTGACTCTGTCTG
GCTAGTCTCGTATCATCTCT	unknown
GCTATGCGCTTCCTGGTCGG	TGAGTGAGTGTCTGAGTCTGTCTCTCAG
GCTATGCGCTTCCTGGTCGG	CTGAGTGAGTGTCTGAGTCTGTC
GCTATTACATATCAGAGTCA	unknown
GCTCACCTCCCGATTCCGGC	CACTCAGTGTGTGTCTGAGACTC
GCTCACCTCCCGATTCCGGC	ACTCAGTGTGTGTCTGAGACTCACAGAG
GCTCACCTCCGTTACGCGTC	unknown
GCTCAGCTGGTCCTCCTGGC	GTGTGAGTGTGACTCTGAGAGACTCTCT
GCTCGGAACACGACGGACGA	unknown
GCTCGGAACAGTGTCCATAC	unknown
GCTCGGTATGGGAGGTCCAA	GTCTCTCAGTCAGAGACTCACACTCAGT
GCTCGGTATGGGAGGTCCAA	GTGTGAGTGTGACTCTGAGAGACTCTCT
GCTCGGTATGTTCACTGGCG	unknown
GCTCTACATACGGACTGAGG	GTCTGTCTCTCTGTCAGAGTGTGTCTCA
GCTCTACATAGCGTTAGATG	unknown
GCTCTACATATCAGATAGAT	unknown
GCTCTTCAATTATAGAAGCT	unknown
GCTCTTCAATTGTATTCAGA	unknown
GCTGCTCTTCAGCAGGCAGC	ACTCTCACACTCTCTCTGTCAGTCTCAG
GCTGCTCTTCTCAGATAGAT	unknown
GCTGGCCGTATCAATGGTGG	unknown
GCTGTGAGACATGCGAGCGT	unknown
GCTGTGAGACCTCGCAGGTC	TGTCAGTGTGTCTGTCTGTGAGTCTCTG
GCTTAGATCTGCGAATCGAC	unknown
GCTTAGTCGGATCCACTAAG	unknown
GCTTAGTCGGGCCTCTGGCT	unknown
GCTTATTCTTTTCGCATAAT	GACGTGTCACTCTGTGTGTCTGTCACTG
GCTTCAGCGCAATCTACAAG	unknown
GCTTCAGCGCCCTGTGAAGT	unknown
GCTTCCTAACCGCCTGGAGA	unknown
GCTTCCTAACGATATGGCAA	unknown
GCTTCTGTACGACTATCACA	unknown
GCTTGACAATCAAGCCTTAG	unknown
GCTTGCGGAATACGTTATGG	unknown
GCTTGCGGAATTCGCATAAT	unknown
GCTTGTCATAACCTCTCCTG	unknown
GGAACGTGCCGTAACGACGC	unknown
GGAACGTGCCTCCAATAGAA	ACTCAGAGAGTGACTGTGACTCTGTCTG
GGAATCAGTTACACACCAGA	ACTCTCACACTCTCTCTGTCAGTCTCAG
GGAATGCCACATTCCGCTCA	CACTCAGAGAGTGACTGTGACT
GGACACTCTTTACTCAGGAA	CGAGTGACTGTCAGTGTGAGAGTG
GGACACTCTTTACTCAGGAA	GAGTGACTGTCAGTGTGAGAGTGTCAGA
GGACACTCTTTCTCGCGACC	unknown
GGACATGAGACCGGTCACTA	CGTGTGAGTGTGACTCTGAGAGTCTCT
GGACATGAGACCGGTCACTA	TGGTGACGTGTGAGTGTGTCTCTGAGAG
GGACATGAGAGTACATAGGC	unknown
GGACATGAGATCCGACCGTA	unknown
GGACATGAGATGCAGTGGTA	GTGCAGTCACAGTGTGACACTGTCTGTG
GGACGCCATAGCGACAGTGT	unknown
GGACGCCATAGTGAACGAGA	unknown
GGAGAATATAGGCTTCGTCG	CGTGACACTGTCTCAGAGACTGACAGA
GGAGATTAATAAGCGCCGTA	unknown
GGAGATTAATATCGGACAAG	CGTGTGAGTGTGACTCTGAGA
GGAGATTAATATCGGACAAG	CGCGAGAGTGTGACTCTGAGA
GGAGATTAATTCGCATCTTG	unknown
GGAGCCTCTCGTCACGTGCT	GTGAGTGACACAGTGTGAGAGTCTGTCA
GGAGCCTCTCTGGATTAGAC	GTGTGAGTGTGACTCTGAGAGACTCTCT
GGAGCCTCTCTGGATTAGAC	GTGTGAGTGTGACTCTGAGAGACTCTCT
GGAGCTATGGAGTCGTCCTA	unknown
GGAGGTTGGTTCTGTTCATA	unknown
GGAGTACGTAGACGAAGACT	GTGAGTCTGACTCTGTCTCTCTGACTGT
GGAGTACGTAGTCGTCGATC	CACTCAGAGAGTGACTGTGAC
GGAGTACGTAGTCGTCGATC	CACTCAGAGAGTGACTGTGAC
GGAGTACGTATGCAAGATAC	unknown
GGAGTATTAAAAGTCGATCC	unknown
GGAGTATTAACTTCCATCCT	unknown
GGAGTATTAATCCAATAGAA	unknown
GGAGTGACCTCGAGGTTAAC	unknown
GGAGTTCGATCCGAATCAGT	unknown
GGAGTTCGATGTGTCCATAC	unknown
GGAGTTCGATTTAATTGCTC	unknown
GGAGTTGACCTGCGGTTACG	unknown
GGATACTGATAATACTCGAT	AGTGTGTCAGAGTGTGTCACACTCTCAG
GGATACTGATCGACGGACGA	unknown
GGATACTGATCTGACCTGGT	GACAGAGAGTCAGTGAGAGACTGGCTCT
GGATACTGATTAGCGCACGT	GTGTGTCTGTGTGTCTGTGTGACTGTGA
GGATACTGATTGTTCACTAG	TGTCAGTGTGTCTGTCTGTGAGTCTCGG
GGATATCTCCTCATCGGATT	unknown
GGATTCGGCCGCTTCTGTAC	GTATGTCTCTCTGTCAGAGTGTGTCTCA
GGATTCGGCCGCTTCTGTAC	GTATGTCTCTCTGTCAGAGTGTGTCTCA
GGATTCGGCCGCTTCTGTAC	GTCTGTCTCTCTGTCAGAGTGTGCCTCA
GGATTCGGCCTCAATGGTGG	unknown
GGCACGACGTCTCACCTAAG	CGTCTCTCAGTCAGAGACTCACAC
GGCACGACGTGACATCGGTG	TCAGAGTCACTGTCACAGACTCTCAACT
GGCACGTTCGGTATTGGCTA	CGTGTGAGTGTGACTC
GGCACTTCCATCCAATAGAA	unknown
GGCAGACCTAGTCTCACAGT	unknown
GGCAGACCTATGACTTCGTA	unknown
GGCAGACTGTGGAGGTTGGT	unknown
GGCATACGTTCTATCGCCTT	unknown
GGCATCGATACTCAAGTCGC	unknown
GGCATCGATAGGCTTCGTCG	AGAGAGTCTCACTGTCAGTGACTGACTG
GGCATTATCGGGAGCTATGG	unknown
GGCCGATACGATCGAGCGAA	unknown
GGCCTGCACAGTTACCACAT	ACTCTCACACTCTCTCTGTCAGTCTCAG
GGCGGCATGACCTTAAGGCT	unknown
GGCGGCATGACGCGACGAGG	unknown
GGCGGCATGACTCTGTCTCC	unknown
GGCGGCATGATGACTTCGTA	unknown
GGCGGCATGATTCTCACTCC	unknown
GGCTAGACAGTTAACCGCGA	unknown
GGCTATATAAACGCCTCAGT	unknown
GGCTCCGCTGCAGGAACGAG	unknown
GGCTCCGCTGGTAACGACGC	ACTCTCACACTCTCTCTGTCAGTCTCAG
GGCTCCGCTGTGGATTAGAC	unknown
GGCTCCGCTGTTCCACTACA	unknown
GGCTCGTATACGTTCTACGA	unknown
GGCTCGTATATTGATATTCC	unknown
GGCTTCGTCGAGGCACACCT	CACACTGTGACTCACACCACTGT
GGCTTCGTCGGAACGCCGTG	GACTCTGTGTCTCACTGTGAGAGTGACT
GGTACACCACATATTCTCAC	unknown
GGTACACCACATCGAGCGAA	unknown
GGTACACCACATCTCGCTGC	unknown
GGTACACCACGCTAGTAGAA	unknown
GGTACACCACTATCGGAATA	TGTGAGACAGTCACAGTGTGTCTGTCTG
GGTACTCTGCTCCTGATCAA	unknown
GGTAGCTCATAACCTTGCGG	unknown
GGTAGCTCATTACGCCGATT	unknown
GGTATATGCCAATCAGTGGA	unknown
GGTCCGGTGTATACCGAGCT	unknown
GGTCTGGTCAATTAACCGGC	unknown
GGTGAGGTGCACTTCAACAC	GTGAGTGACACAGTGTGAGAGTCTGTCA
GGTGATTACGAGTGGTGGTA	unknown
GGTGATTACGATTATCTAGC	unknown
GGTGCATTGGTACGTTATGG	CAGTGAGTGTCTGACTGTCTGACTCT
GGTGCGCGTAGCGACAGTGT	unknown
GGTGCGCGTAGCGTTAGATG	unknown
GGTGGAAGGTGACATCGGTG	unknown
GGTGGAAGGTGCGTTAGATG	TGTCTCTGTGTCTGAGAGAGTCTGTCAG
GGTGGAAGGTTACAGTACGC	unknown
GGTGTTATAAATGGAAGGCC	unknown
GGTTACAGTAGGCTCCAAGC	unknown
GGTTACAGTAGTTGCGCCGG	unknown
GGTTAGTGGCAGACTTACGT	GTGAGTGACACAGTGTGAGAGTCGGTCA
GGTTAGTGGCAGACTTACGT	GTGAGTGACACAGTGTGAGAGTCTGTCA
GGTTAGTGGCGAGGTGCCGC	unknown
GGTTAGTGGCGCCAGCTTCG	unknown
GGTTAGTGGCGTTAAGGTGA	GTCTGTCTCTCTGTCAGAGTGTGTCTCA
GGTTAGTGGCTACGCCGATT	unknown
GGTTGAGCCGACGTTGAATA	unknown
GGTTGAGCCGCCTGCTTAGT	unknown
GGTTGAGCCGGTTAAGGTGA	unknown
GGTTGGTAACCAGGAACGAG	unknown
GGTTGGTAACCGAATATAGG	unknown
GGTTGGTAACTCTTGGAGAC	unknown
GTAACCACCGATGTCTGCCA	AACGTGTGAGTGTGACTCTGAGAGACTC
GTAACGACGCACATCATTGC	unknown
GTAACGGATGACTTCAACAC	unknown
GTAACTGAGTCGGACCACCT	unknown
GTAACTGAGTGTATTGGCTA	unknown
GTAATACGTCAAGTTCGACC	unknown
GTAATACGTCTAAGCGTGGC	unknown
GTAATCTTCACTGATACTTC	CGAGAGACTGTCACTGTCTCTGACACTG
GTAATCTTCATGTTCCAGAC	GACACACTGACTGTGTGAGTCTCAGAGT
GTACATAGGCTACCATGACT	unknown
GTACGAGTTGAGGTTAGGAG	GTGTGAGTGTGACTCTGAGAGACTCTCT
GTACGAGTTGAGGTTAGGAG	GTGTGAGTGTGACTCTGAGAGACTCTCT
GTACGAGTTGGGTGCAACCT	unknown
GTAGACGGAGATGATCATTA	GTCTGTCTCTCTGTCAGAGTGTGGCTCA
GTAGACGGAGCGATATGTGC	CTGTGAGACAGTCACAGTGT
GTAGACGGAGCTTGTAGCAT	ACTCTCACACTCTCTCTGTCAGTCTCAG
GTAGACGGAGCTTGTAGCAT	ACTCTCACACTCTCTCTGTCAGTCTCAG
GTAGACGGAGTTAACCGCGA	GTCGTTTCTCAGTCAGAGACACACACT
GTAGGATCAGTCGCATCTTG	unknown
GTAGGCGAGGCTCAACATGT	unknown
GTAGGCGAGGTAGGCTCAGG	unknown
GTAGGTACCTCTCACAGCGG	unknown
GTAGGTACCTGTGTGAAGTT	unknown
GTAGTACCGGAGATTGCTCA	unknown
GTAGTACCGGAGTCGACCAT	unknown
GTAGTACCGGGTCAGTACCA	CGTGTCTGTCAGTCTCTGAGGTC
GTAGTACCGGTAAGCGTGGC	ACTCAGAGAGTGACTGTGACTCTGTCTG
GTAGTACCGGTAAGCGTGGC	ACTCAGAGAGTGACTGTGACTCTGTCTG
GTATATGAAGTCCGAAGATT	CGTGTCTCTCTGGCTGACTCTGTGTGTG
GTATATGAAGTCCGAAGATT	GTGTGTCTCAGACAGACTGTCTGTCTGT
GTATATGAAGTCCGAAGATT	GTGTCTCTCTGACTGACTCTGTGTGTGT
GTATATGAAGTCCGAAGATT	CGTGTCTCTCTGACTGACTCTGT
GTATATGAAGTCCGAAGATT	GTGTGTCTCAGACAGACTGTCTGTCTGT
GTATATGAAGTCCGAAGATT	CGTGTCTCTCTGACTGACTCTGTGTG
GTATTCAACAGTGCGAACAT	GACGTGTCACTCTGTGTGTCTGTCACTG
GTATTCAACAGTGCGAACAT	GACGTGTCACTCTGTGTGTCTGTCACTG
GTATTCAACAGTGCGAACAT	GGACGTGTCACTCTGTGTGTCTGTC
GTATTCAACAGTGCGAACAT	GACGTGTCACTCTGTGTGTCTGTCACTG
GTATTCAACAGTGCGAACAT	GACGTGTCACTCTGTGTGTCTGTCACTG
GTATTCAACAGTGGCAGGTG	GACTCTGTGTCTCACTGTGAGAGTGACT
GTCAAGCAGAGCCTCTGGCT	unknown
GTCACGTGCTTGAGGTGGTT	unknown
GTCACTAGGAAAGGAATGTA	GTGTGTCTGTGTGTCTGTGTGACTGTGA
GTCACTAGGAACATATGCGA	CGACCTCAGAGTCACTGTCACAGACTCT
GTCACTAGGAACATATGCGA	TCAGAGTCACTGTCACAGCCTCACACCT
GTCACTAGGAACATATGCGA	GACTGTGTCTCTGACAGTCTCAGAGTGT
GTCAGCATGCATGTCCGTGC	GTGTGTCTGTGTGTCTGTGTGACTGTGA
GTCAGCATGCCTAGACACTT	unknown
GTCAGGTCGTATATTCTCAC	CGTCTGTCTCTCTGTCAGAGTGTGTCT
GTCAGTACCAGGCCTGCACA	unknown
GTCAGTACCATTAACGTAGG	unknown
GTCCATATGGACGGCGAGGC	CGACTCAGAGTGTCTGTGACACACTCA
GTCCGTCACAAACGAGGTCC	unknown
GTCCGTCACATTCTATCAGC	unknown
GTCCTTGCACCGCACTGGAT	unknown
GTCCTTGCACCGCGAGTCGA	unknown
GTCCTTGCACTTCACTGGCG	unknown
GTCGAAGTCAGGCTATATAA	GTCTCTCAGTCAGAGACTCACACTCAGT
GTCGAAGTCAGTAACGACGC	GTGTGAGTGTGACTCTGAGAGACTCTCT
GTCGCCTCTTATACTGAGGA	unknown
GTCGCCTCTTGGAACGTGCC	GTGTGAGTGTGACTCTGAGAGACTCTCT
GTCGCCTCTTTTCCACTACA	unknown
GTCGCCTTGAATGTCTGCCA	AGTGAGTCTCACTGTCAGTGACTGACTG
GTCGCCTTGAATGTCTGCCA	AGAGAGTCTCACTGTCAGTGACTGACTG
GTCGCCTTGACTTCCTACAG	unknown
GTCTAATGCACGTTCTACGA	unknown
GTCTAATGCAGGAGGTCCAA	unknown
GTCTACCTTCCAAGCTGAAG	unknown
GTCTACTGACCTCACTGTAG	unknown
GTCTCACAGTCTTGTAGCAT	unknown
GTCTGAGCACCCTTAAGGCT	unknown
GTCTGAGCACGTTACCACAT	CGTGTGTCTGTGTGTCTGTGTGACTGT
GTCTGGTACGATGGAAGGCC	TGTGAGACAGTCACAGTGTGTCTGTCTG
GTCTGGTACGCGCCTCTCGG	ACTCAGAGAGTGACTGTGACTCTGTCTG
GTCTGGTACGCGCCTCTCGG	ACTCAGAGAGTGACTGTGACTCTGACTG
GTCTGGTACGCGCCTCTCGG	ACTCAGAGAGTGACTGTGACTCTGTCTG
GTCTGGTACGCGCCTCTCGG	GAGACTGTGTCTGTGTCAGTCTCTCTCA
GTCTTCGGCTCCTGCTTAGT	unknown
GTGAACGAGAAAGTAAGCGT	GTCTGACTCAGACTGTGTGTGTGTGTCT
GTGAACGAGAAAGTAAGCGT	GACTCTGTGTCTCACTGTGAGAGTGACT
GTGAACGAGAAAGTAAGCGT	GTGTGACTCAGACTGAGTGTGTGTGTCT
GTGAACGAGAAAGTAAGCGT	CGACTCTGTGTCTCACTGTGAGAGTGAC
GTGAACGAGATGTAAGAGCT	unknown
GTGAACGAGATTCTATCAGC	unknown
GTGAAGATCTACAGTTCATT	CGTGAGTGACACAGTG
GTGAAGTCGGGAACGAATTC	unknown
GTGAAGTCGGGGTATCCTTA	GTGAGTGACACAGTGTGAGAGTCTGTCA
GTGACCTAACGACTATCACA	GACTCAGAGTGTCTGTGACACACTCACA
GTGACCTAACGCTCTCGGTT	CGACTGTGTCACAGAGTCACAGTCTCT
GTGACCTAACGCTCTCGGTT	GACTGTGTCACAGAGTCACAGTCTCGCT
GTGACTGTACCACTCAGTCA	unknown
GTGACTGTACGCCAGCTTCG	unknown
GTGACTGTACTGATGACGTA	GTCTGTCTCTCTGTCAGAGTGTGTCTCA
GTGAGCGGAACGTTCAATAA	unknown
GTGAGTCATACGATAAGCAC	GTGTGAGTGTGACTCTGAGAGACTCTCT
GTGAGTCATACGATAAGCAC	GTGTGAGTGTGACTCTGAGAGACTCTCT
GTGAGTCATACGATAAGCAC	GAGTGAGTGTGACTCTGAGAGACTCTCT
GTGAGTCATACGATAAGCAC	GTGTGAGTGTGACTCTGAGAGACTCTCT
GTGAGTCATACGATAAGCAC	ATGTGAGTGTGACTCTGAGAGACTCTCT
GTGATATAGTAAGATCAATT	GACTCAGAGTCACAGTCAGAGACTGTGA
GTGATATAGTCCGAATCAGT	GTGAGTGACACAGTGTGAGAGTCTGTCA
GTGCCACCTGACGGCCTGTA	CGTGAGTCTGACTCTG
GTGCCACCTGAGTAGTAATA	unknown
GTGCCACCTGTTCTCCTGTA	unknown
GTGCGAACATTATCATCTCT	CGTGTGAGTGGGACTCTGAGAGACCCT
GTGCGAACATTATCATCTCT	CGTGTGAGTGTGACTCTGAGTGAC
GTGCGGTTCAAAGTTCGACC	CTGACAGTGTGTGTCAGTGTCAGAGA
GTGCGGTTCAACGGCGAGGC	unknown
GTGCGGTTCAAGAGAGTCGC	GTCACACTGTCTCTGTCTCAGTCAGAGA
GTGCGGTTCATGGTATTGTC	TGACCTGTGACACTCAGTGTGTCTGTCA
GTGCGGTTCATGGTATTGTC	GACTCAGAGTGTCTGTGACACACTCACA
GTGCGTATGTATGATCATTA	GACTCAGAGTGTCTGTGACACACTCACA
GTGCGTATGTCGAATATAGG	GTCTGTCTCTCTGTCAGAGTGTGTCTCA
GTGCGTATGTGTGTCACGAG	CGTGAGTGAGTCTCAGTGACTCTCAGAG
GTGCGTATGTGTGTCACGAG	CGACTCAGAGTGTCAGTGAC
GTGCTAAGAATCTTCATCTC	unknown
GTGGACAGGATCGTAGTCGT	GTGTGAGTGTGACTCTGAGAGACTCTCT
GTGGAGCTACGTCGCGATTC	unknown
GTGGAGTGTCCCTGCGAACA	CTGTCTGACACTGAGACAGTCA
GTGGAGTGTCCCTGCGAACA	TGTCTGACACTGAGACAGTCACAGTCTG
GTGGCAGGTGTCTCGCGACC	GTGCAGTCACAGTGTGACACTGTCTGTG
GTGGCAGGTGTGCAAGATAC	GTGACACTGTCTCAGAGACTGACAGAGA
GTGTCACGAGATGCGAGCGT	GTGTGAGTGTGACTCTGAGAGACTCTCT
GTGTCACGAGCTCGATTGGT	GACGTATCACTCTGTGGGTCTGACACTG
GTGTCACGAGTTAACGTAGG	unknown
GTGTCCATACATGGAAGGCC	unknown
GTGTGAAGTTCATGCTGACT	unknown
GTGTTAACTAAATTCGAAGG	unknown
GTGTTAATGTCTTGACTCAA	unknown
GTGTTATCCGACGACTATTA	CGTGTCACAGACACACTGAGA
GTGTTATCCGACGACTATTA	GTGTCACAGACACTCTGAGACTCTGTCA
GTGTTATCCGACGACTATTA	CGTGTCACAGACACTCTGAGACTCTGT
GTGTTATCCGATAGCTGGAT	unknown
GTGTTATCCGCCATCGTGAC	unknown
GTGTTGGAACCATAGGACTG	unknown
GTGTTGGAACCGTATTGCTC	unknown
GTTAACAACTCTAAGATATT	unknown
GTTAACAACTGATGAGAGGT	GTCTGTCTCTCTGTCAGAGTGTGTCTCA
GTTAACAACTTCCGACCGTA	GTCTGTCTCTCTGTCAGAGTGTGTCTCA
GTTAACAACTTGGTATTGTC	unknown
GTTAAGGCTTGATGAGAGGT	CGTGTGAGTGTGACTCTGAGA
GTTAAGGTGAAGTCGACCAT	unknown
GTTAAGGTGATCCGACCGTA	unknown
GTTAATAATCCGTACCGCGA	AGAGTGTCTCACTGTCAGTGACTGACTG
GTTAATAATCTGGAGCTCAG	unknown
GTTACCACATCGACGGACGA	CAGAGAGTCACACTGTCAGTGA
GTTACCACATCGTATTGCTC	unknown
GTTACCACATCTTCCGATAA	unknown
GTTATAGATGAGTCGTCCTA	unknown
GTTCGCAATGTAATCGGTGC	GTGTGAGTGTGACTCTGAGAGACTCTCT
GTTCGTGTCAAATGCCAGTT	unknown
GTTGACGGCTAATAATGCAC	GTGTGTGTGAGTGTGTGACTGTGTCTGA
GTTGACGGCTAATAATGCAC	GTGTGAGTGAGTGTGTGACTGTGTCTGA
GTTGACGGCTCTAGGCCACG	unknown
GTTGACGGCTGTCCAGACGA	unknown
GTTGATGGTCCTTCAATAAT	unknown
GTTGCATGGTACTGGTAAGA	GTGTGAGTGTGACTCTGAGAGTCTCTCT
GTTGCATGGTACTGGTAAGA	GTGTGAGTGTGACTCTGAGAGACTCTCT
GTTGCATGGTCGAGGAGTCA	GACTGTGTCACAGAGTCACAGTCTCACT
GTTGCATGGTGACCAGTACG	CACTCTCACACTCTCTCTGT
GTTGCGCCGGGACTATCACA	ACTCAGAGAGTGACTGTGACTCTGTCTG
GTTGCTCCTTCTTCAATAAT	GTGTGAGTGTGACTCTGAGAGACTCTCT
GTTGCTCCTTTACGAAGTGC	unknown
GTTGGATCCTCAAGCCTTAG	unknown
GTTGGATCCTGCTGTGAGAC	unknown
GTTGGATCCTTCCTCCTGGC	GTGTGAGTGTGACTCTGAGAGACTCTCT
GTTGGTACAGAAGTCGATCC	unknown
GTTGGTACAGCTTCCTACAG	CGTGAGTGACACAGTGTGAGAGT
GTTGGTACAGGGCTATATAA	GACTCAGAGTGTCTGTGACACACTCACA
GTTGGTACAGGGCTATATAA	GACTCAGAGTGTCTGTGACACACTCACA
GTTGGTACAGGTTAAGGTGA	unknown
GTTGTATGCATACGTTATGG	ACTCTCACACTCTCTCTGTCAGTCTCCG
GTTGTCTGACTACAGTACGC	unknown
GTTGTTCTCTCTTACCGGTG	unknown
TAACAGCCAAATCAGTTAAC	unknown
TAACAGCCAAGCTAGTAGAA	GTGTGAGTGTGACTCTGAGAGACCCTCT
TAACAGCCAAGCTTAGATCT	unknown
TAACAGCCAATAGTTAGACG	unknown
TAACATAGCAGATTCAGAGA	GTGAGTGACACAGTGTGAGAGTCTGTCA
TAACATCTAGCGCGAGTCGA	CACTCTCACACTCTCTCTGTCAGTC
TAACATTGTGCTTACCGGTG	unknown
TAACATTGTGTAATCGGTGC	unknown
TAACATTGTGTGCAAGATAC	CCGTCTCTCAGTCAGAGACTCACACTCA
TAACATTGTGTGCAAGATAC	GTCTCTCAGTCAGAGACTCACACTCGGT
TAACCGCACAGACTGTTCCT	CGTGTGAGTGTGACTCT
TAACTTCATGAAGATTAACC	GTGACACTGTCTCAGAGACTGACAGAGA
TAACTTCATGAAGATTAACC	GTGACACTGTCTCAGAGACTGACAGAGA
TAACTTCATGATACCGAGCT	CGTGACACTGTCTCAGAGACTGACAGAG
TAAGGAGAAGGCTGCTCTTC	GAGAGTGAGTCTCAGTGACTCTCAGAGT
TAATAGTTAAACTGCACAGG	unknown
TAATAGTTAATGCTCAGAAG	GTCTGTCTCTCTGTCAGAGTGTGTCTCA
TAATAGTTAATTCTCCTGTA	unknown
TAATCGGTGCCAGCGAAGTC	unknown
TAATCGGTGCCCTTAAGGCT	unknown
TAATCGGTGCTGCTCAGAAG	unknown
TAATCTTACGGAACGCCGTG	unknown
TAATCTTACGGTTGTTCTCT	unknown
TAATTCGCTGATTACCGCGT	unknown
TACAAGCACCAATACTCGAT	GACGAGTCACTCTGTGTGTCTGTCACTG
TACAAGCACCAATACTCGAT	GACGTGTCACTCTGTGTGTCTGTCACTG
TACAAGCACCACAGTTCATT	unknown
TACACTAGCCATAACATACG	GACTGACTGTGTGACTCTGAGACAGTCA
TACACTAGCCATAACATACG	GACTGACTGTGTGACTCTGAGACAGTCA
TACAGCATCAGATATAGCGG	unknown
TACAGCCGAGCAGTGTATGC	GTGTGAGTGTGACTCTGAGAGACTCTCT
TACAGCCGAGCAGTGTATGC	GTGTGAGTGTGACTCTGAGAGACTCTCT
TACAGCCGAGGCCAGCACGT	unknown
TACAGTACGCCAGTGTATGC	unknown
TACAGTACGCGTATTGGCTA	unknown
TACAGTACGCGTCTACCTTC	unknown
TACATGTGCCATTATTGTGC	unknown
TACCACACGGTTCCACTACA	unknown
TACCATGACTTATATGCGTT	GTGAGTGACACAGTGTGAGAGTCTGTCA
TACCATGACTTATATGCGTT	GTGAGTGACACAGTGTGAGAGTCTGTCA
TACCGTCAGCCATCAATTAA	GTCTCTCAGTCAGAGACTCACACTCAGT
TACCGTCAGCGATTGATGGC	unknown
TACCTCGTACATCCACTAAG	GTGTGAGTGTGACTCTGAGAGACTCTCT
TACCTCGTACCGTATTGCTC	unknown
TACGAAGTGCCTAAGAGTCC	GTGTGAGTGTGACTCTGAGAGACTCTCT
TACGAAGTGCCTCACCTAAG	GACTCAGAGTGTCTGTGACACACTCACA
TACGCCGATTTAAGCGTGGC	unknown
TACGCTGACCACGACGTCCA	unknown
TACGCTGACCCTCACTGTAG	unknown
TACGCTGACCGCGAACACGG	GTCTCTCAGTCAGAGACTCACACTCAGT
TACGTAACAGGGAGTACGTA	unknown
TACGTAACAGTAATCGGTGC	unknown
TACGTAACAGTGGTATTGTC	CGTGAGTGAGTCTCAGTGACTCT
TACGTAACAGTGGTATTGTC	GTCTCAGTGTCAGACACTGACAGAGTGA
TACGTGACGAGTAACGACGC	unknown
TACGTTATGGCTCAACATGT	GAGAGACTGTCACTGTCTCTGACACTGT
TACTATCCTCAAGCGCCGTA	GTATGTCTCTCTGTCAGAGTGTGGCTCA
TACTATCCTCAAGCGCCGTA	GTCTGTCTCTCTGTCAGAGTGTGTCTCA
TACTATCCTCGTGTCACGAG	TGTCAGTGTGTCTGTCTGTGAGTCTCTG
TACTATCCTCGTGTCACGAG	CTGTCAGTGTGTCTGTCTGTGAGTCT
TACTATCCTCGTGTCACGAG	TGTCAGTGTGTCTGTCTGTGAGTCTCTG
TACTGCTACATGGATTAGAC	unknown
TACTGTGTCAACGACGTCCA	unknown
TACTGTGTCAATGGCGTGCG	unknown
TAGAACTCGAGCCGCAATAG	unknown
TAGAAGACTCAGAATTCAGT	CACTCTCACACTCTCTCTGTCAGTCTCA
TAGAAGACTCAGAATTCAGT	ACTCTCACTCTCTCTCTGTCAGTCTCAG
TAGAAGACTCAGAATTCAGT	CACTCTCACACTCTCTCTGTCAGTC
TAGAATGATTCAAGCCTTAG	CGTGACACTGTCTCAGAGACTGA
TAGAATGATTGACCAGTACG	unknown
TAGAATGATTGTAATACGTC	unknown
TAGAATGATTGTGCGAACAT	TGACAGTGTGTGTCAGTGTCAGAGAGAG
TAGAATGATTGTGCGAACAT	CCCTGACAGTGTGTGTCAGTGTCAGAGA
TAGATAGCGTTCAATGGTGG	unknown
TAGATCTAATGCACTTCACG	unknown
TAGCGCATTAACATCATTGC	unknown
TAGCGCATTAATCGAGCGAA	unknown
TAGCGCATTAATGGAAGGCC	GAGACTGTGTCTGTGTGACTCTCTGTGA
TAGCGCATTATTCGTAGCAC	GACTCTGTGTCTCACTGTGAGAGTGACT
TAGCGGTTGCACGACAATAT	unknown
TAGCTGCTACAGTGTTGCTT	unknown
TAGCTGCTACGGTGCAACCT	unknown
TAGGAACTCGAATAATGCAC	GTGAGTCTGACTCTGTCTCTCTGACTGT
TAGGACAGCCAATCAGTGGA	unknown
TAGGACAGCCCGTTCAATAA	unknown
TAGGACAGCCGCGTACAACT	GTCTGTCTCTCTGTCAGAGTGTGTCTCA
TAGGACAGCCGCGTACAACT	GTATGTCTCTCTGTCAGAGTGTGACTCA
TAGGACAGCCTCGACATCGA	GTGTGAGTGTGACTCTGAGAGACTCTCT
TAGGATAGTTACGACAATAT	unknown
TAGGCGCATTCTCTAAGCAT	unknown
TAGGCGCATTCTGCAGGATA	CGTGTGAGTGTGACTCTGAGAGACTCT
TAGGCGCATTGCTCGGTATG	GTGAGTGACACAGTGTGAGAGTCGGGCA
TAGGCGCATTGCTCGGTATG	ACACTGAGACTCACACCTCTGTCTCAGT
TAGGCGCATTGCTCGGTATG	GTGAGTGACACAGTGTGAGAGTCTGTCA
TAGGCGCATTTAGTCGGAAT	GTGTGAGTGTGACTCTGAGAGACTCTCT
TAGGCGCATTTAGTCGGAAT	GTGTGAGTGTGACTCTGAGAGACTCTCT
TAGGCGCATTTAGTCGGAAT	GTGTGAGTGTGACTCTGAGAGACTCGCT
TAGGCTCAGGCTTGCCGCGC	CGTGAGTGACACAGTG
TAGGCTCAGGCTTGCCGCGC	CGTGAGTGACACAGTGTGAGAGTCTGTC
TAGGCTCAGGCTTGCCGCGC	CGTGAGTGACACAGTGTGAGA
TAGGCTCAGGGTGGACAGGA	unknown
TAGGCTCAGGTAGTCGGAAT	GAGTGACTGTCAGTGTGAGAGTGTCAGA
TAGTACAATTATCTCGCTGC	GTGTGAGTGTGTGTGTGAGAGAGACACT
TAGTACAATTATGTTCTATA	unknown
TAGTACAATTTGCGGTTACG	unknown
TAGTAGGCCTATTATCTAGC	GTCTGTCTCTCTGTCAGAGTGTGTCTCA
TAGTAGGCCTATTATCTAGC	CGTCTGTCTCTCTGTCTGAGTGTG
TAGTAGGCCTGCTTAGATCT	unknown
TAGTCGCGCCAGGCACACCT	unknown
TAGTCGCGCCATACTCCTAC	unknown
TAGTCGCGCCTATGAACAGC	CGTGAGTCTGACTCTGTCTCTCT
TAGTCGCGCCTTACTGCCTT	GTGTCTGTCTCAGACAGAGTGTCAGACA
TAGTCGGAATGTCACGTGCT	TCAGAGTCACTGTCACAGACTCTCAACT
TAGTCTACACGCTCTCGGTT	GTGTGTCTCTCTGTCAGAGTGTGGCTCA
TAGTTAGACGGTAATTGACA	unknown
TAGTTAGACGTTACTGCCTT	unknown
TATAAGTATTACTGCACAGG	unknown
TATAAGTATTCTTGACTCAA	unknown
TATAAGTATTTATGAACAGC	CTGTCTCTGTGTCTGAGAGAGTCTGTCA
TATAAGTATTTATGAACAGC	TGTCTCTGTGTCTGAGAGAGTCTGTCAG
TATAATTAGGACGACTATTA	unknown
TATACATTCGGCTTCTGTAC	unknown
TATAGAAGCTAGACCGATCG	unknown
TATATCACACGCGAATCGAC	GTATGTCTCTCTGTCAGAGTGTGTCTCA
TATATCACACTATCATCTCT	CACTCAGAGAGTGACTGTGACTCTGT
TATATGCGTTCAGCGAAGTC	unknown
TATATGCGTTTAACAGCCAA	GAATCAGAGTGTCTGTGACACACTCACA
TATATGTTATCGCGAGTCGA	unknown
TATATGTTATGAGGTGCCGC	unknown
TATCACTGACGCAACAGAAC	unknown
TATCATCTCTAAGTTGGAGG	unknown
TATCGCGCCAAATCTACAAG	unknown
TATCGCGCCACGAATATAGG	unknown
TATCGCGCCAGCGAATCGAC	TAAGAGTCACTGTCACAGACTCTCAACT
TATCGCGCCATGTGTGTAAC	CGACTCAGAGTGACAGTCAGAGACTGT
TATCTACACAGACTCTCCAA	unknown
TATCTCGGCTTATCGGAATA	unknown
TATCTTGGTCTTAATTGCTC	unknown
TATGCTCTCCTCGATGCGCG	unknown
TATGCTCTCCTGGAGCTCAG	unknown
TATGGCATAGAGAGAGTCGC	CTCACACACTGAGACACACTCTGACA
TATGGCATAGAGAGAGTCGC	TCACACACTGAGACACACTCTGACACTG
TATGTATGGCACAGTTCATT	GTGTGAGTGTGACTCTGAGAGACACACT
TATGTATGGCACAGTTCATT	GTGTGAGTGTGACTCTGAGAGACTCTCT
TATGTATGGCACAGTTCATT	GTGTGAGTGTGACTCTGAGAGACTCTCT
TATGTATGGCGACTCACCTT	GTGAGTGACACAGTGTGAGAGTCTGTCA
TATGTATGGCGACTCACCTT	GTGAGTGACACAGTGTGAGAGTCTGTCA
TATTACTCTCCCGTGCAACC	TAACACTCTGAGAGTGTGTCAGACAGTG
TATTCATATATCCTGATCAA	unknown
TATTCTTAATAATGCCAGTT	CGTGAGTGAGTCTCAGTGACT
TATTCTTAATGTCACGTGCT	unknown
TATTGAGGTCAATTCGAAGG	unknown
TATTGTCACACGCGACGAGG	unknown
TCAACCGCTCCGATTGATAA	unknown
TCAACGAACCTTCACTGGCG	unknown
TCAATCGTCCTAGTTGTCAC	GACTGTGAGTCACTCACTGTCACTCTCT
TCAATCGTCCTAGTTGTCAC	GACTGTGAGTCACTCACTGTCACTCTCT
TCAATCGTCCTTCCACTACA	GTGTGAGTGTGACTCTGAGAGACTCTCT
TCAATGGTGGGCCTCTGGCT	unknown
TCAATGGTGGGGAACGTGCC	unknown
TCAATGGTGGTACAGTACGC	unknown
TCACGAATCCTCCAATAGAA	CGTGAGTCTGACTCTGTCTCTCT
TCACGGCGGCACGACAATAT	unknown
TCACGGCGGCGCTCGGTATG	unknown
TCACGGCGGCGCTTAGTCGG	unknown
TCACTGCTTCAAGTTGGAGG	unknown
TCAGCGCAATGATATAGCGG	unknown
TCAGGTAAGTGCCAGCTTCG	unknown
TCAGTACACGTGTAAGAGCT	GTGTCTCTCTGACTGACTCTGTGTGTGT
TCAGTACACGTGTAAGAGCT	CGTGTGTCTCAGACAGACT
TCAGTACACGTGTAAGAGCT	GGCGTGTGTCTCAGACAGACT
TCATCCTTGGACTGGTAAGA	AGAGAGTCTCACTGTCAGTGACTGACTG
TCATCCTTGGGCTTAGATCT	CTGTGAGTCAGTCACAGTGTGTCTGT
TCATCGGATTAATACTCGAT	unknown
TCATCGGATTCTCAACATGT	GAGTGACTGTCAGTGTGAGAGTGTCAGA
TCATCGTTCCTCGCATCTTG	unknown
TCCAATCTCGGCAACAGAAC	unknown
TCCAATCTCGTACGTTATGG	GTTTCTGACTCAGTGAGTGTCTGACACA
TCCAGGTACTCTAGTGTAAC	unknown
TCCAGGTACTGTGAACGAGA	unknown
TCCAGGTACTTAGGCTCAGG	unknown
TCCGAAGATTTAGTTGTCAC	unknown
TCCGACCGTAAGTTGTCGAA	unknown
TCCGACCGTACTATCGCCTT	GTCTCTCAGTCAGAGACTCACACTCAGT
TCCGACCGTACTATCGCCTT	CGTATCTCAGTCAGAGACTCACAC
TCCGACCGTATTCTCCTGTA	unknown
TCCGACTTAAGAACGAATTC	GTCTCTCAGTCAGAGACTCACACTCAGT
TCCGCGGTCGCGCGACGAGG	GACGAGTCACTCTGTGTGTCTGTCACTG
TCCGTCTATAAGATTGAGAG	unknown
TCCGTCTATACCATCGTGAC	unknown
TCCGTCTATATCGACATCGA	unknown
TCCTAACAATCAGTGTATGC	unknown
TCCTAAGGCCAAGTTCGACC	unknown
TCCTAAGGCCGTAACGACGC	TGTGAGACAGTCACAGTGTGTCTGTCTG
TCCTCCTGGCGAGACAACGG	CACTCTCACACTCTCTCTGTCAG
TCCTCCTGGCGCACATAGTA	GAGGACGTGACTGTCTCA
TCCTCCTGGCGCTCTCGGTT	unknown
TCCTCGAGTATATCGCGCCA	unknown
TCCTCGTGCGAACGAGTATT	unknown
TCCTGATCAAAAGTTCGACC	CAGACAGTGTGTGTCAGTGTCAGAGAG
TCCTGATCAATAGTTGTCAC	unknown
TCCTGCGAGAAACTTGCACC	unknown
TCCTGCGAGATTAACCGCGA	unknown
TCCTGGATCTACGACAATAT	unknown
TCCTGGATCTTAACATAGCA	unknown
TCCTTACCGACTAGGCCACG	unknown
TCCTTATGATGCTAGTAGAA	unknown
TCCTTGCCAGGTCCAGACGA	unknown
TCGAACGCCAACGACTATTA	GTGAGTGACACAGTGTGAGAGTCTGTCA
TCGAACGCCAGGTGCAACCT	unknown
TCGAACGCCATAACATAGCA	unknown
TCGACAGACCACGGTACCTC	GTCTCTCAGTCAGAGACTCACACTCAGT
TCGACAGACCACGGTACCTC	GTCTCTCAGTCAGAGACTCACACTCAGT
TCGACAGACCTACGCCGATT	unknown
TCGACATCGACTTGCCGCGC	unknown
TCGACGTCAGAATTCGAAGG	unknown
TCGACGTCAGTTGAAGAAGC	unknown
TCGAGAAGTGCTTACCGGTG	unknown
TCGAGCCTTCACGCCTCAGT	ACTCTCACACTCTCTCTGTCAGTCTCAG
TCGAGCCTTCACGCCTCAGT	ACTCTCACACTCTCTCTGTCAGTCTCAG
TCGAGCCTTCCGAATATAGG	unknown
TCGAGCCTTCGCACATAGTA	unknown
TCGATATCCTACCTCTCCTG	unknown
TCGATGCGCGATGTTCTATA	unknown
TCGCAGCTGTAATACTCGAT	GACTCAGAGTGTCTGTGACACACTCACA
TCGCAGCTGTGACCAGTACG	unknown
TCGCATCTTGACGGTACCTC	unknown
TCGCGGTATTCGATAAGCAC	unknown
TCGCGTTAGGGCTTAGTCGG	unknown
TCGCTCGGTGCGTCCGCTCT	unknown
TCGCTCGGTGCTTCGATGGT	unknown
TCGCTCGGTGTGTTCACTAG	unknown
TCGCTTCAAGGACCAGAATA	unknown
TCGCTTCAAGTCTCGCGACC	unknown
TCGGCGCTGCTATATGCGTT	unknown
TCGTAGATCGCGCCTCATCT	unknown
TCGTAGTCGTAAGTTCGACC	unknown
TCGTAGTCGTTCGTAGTCGT	unknown
TCGTAGTCGTTTGATCTTAA	CGTGAGTGACACAGTGTGAGA
TCGTGACAAGAAGTCGATCC	unknown
TCGTGGCAGAATTATCTAGC	unknown
TCGTGGCAGACGTATCGCCT	unknown
TCTAACACGTTCCGTGAAGC	unknown
TCTACAGTGGGTTACCACAT	unknown
TCTACAGTGGTAGCTGCTAC	GTGTCTCTCTGACTGACTCTGTGTGTGT
TCTACAGTGGTAGCTGCTAC	GTGTCTCTCTGACTGACTCTGTGTGTGT
TCTACAGTGGTAGCTGCTAC	GTGTCTCTCTGACTGACTCTGTGTGTGT
TCTACAGTGGTAGCTGCTAC	GTGTGTCTCAGACAGACTGTCTGTCTGT
TCTACGGTAAGAGTAGATTG	CGTGAGAGTGTGACTCTGAGTGA
TCTACGGTAAGAGTAGATTG	CGTGTGAGTGTGACTCTGA
TCTACGGTAAGTCACGTGCT	unknown
TCTACTGCAGATAGAGAGCC	unknown
TCTACTGCAGGTAATTGACA	GTGTGAGTGTGACTCTGAGAGACACTCT
TCTACTGCAGGTAATTGACA	GTGTGAGTGTGACTCTGAGAGACTCTCT
TCTCCATGACGCGAATCGAC	CGTCTCTCAGTCAGAGACTCACA
TCTCCATGACGTAATACGTC	unknown
TCTCGCCGATACATATGCGA	unknown
TCTCGCGACCCAACTCGTCG	CTGTCAGTGTGTCTGTCTGTGAGTCTC
TCTGAATGATTCCTGGTCGG	CAGAGAGTCTCACTGTCAGTGACTG
TCTGAATGATTCCTGGTCGG	AGAGAGTCTCACTGTCAGTGACTGACTG
TCTGATAGCGGGAGCAACAG	unknown
TCTGATAGCGTCCGACCGTA	unknown
TCTGATCTAACCGTGCAACC	unknown
TCTGATCTAAGACCAGAATA	GTGTGAGTGTGACTCTGAGAGACTCTCT
TCTGATCTAAGGAGCTATGG	unknown
TCTGCGCACGCCGAATCAGT	unknown
TCTGGATAGTATGTCCGTGC	TGACAGTGTGTGTCAGTGTCAGAGAGAG
TCTGGATAGTCATAGGACTG	unknown
TCTGTAGGCCAGGAGCTCCA	unknown
TCTGTTCATACGGCAGAGTC	unknown
TCTGTTCATACGGCGATACC	unknown
TCTTACAACGATAACATACG	GTGTGTCTGTGTGTCTGTGTGACTGTGA
TCTTACAACGCTTCCATCCT	unknown
TCTTACAACGTCGCATCTTG	unknown
TCTTATGTTAAGTAGTTACG	unknown
TCTTATGTTACGCTGAATTC	unknown
TCTTATGTTACTAGACACTT	unknown
TCTTCATCTCGGCTATATAA	GTGTGAGTGTGACTCTGAGAGACTCGCT
TCTTCCACAGAGATTGCTCA	CTGACAGTGTGTGTCAGTGTCA
TCTTCCACAGTGCAAGATAC	unknown
TCTTCTCGGCCGGCGATACC	GTGTCTCCGACTGTCTGTGTGACTGACT
TCTTGGAGACGAACGAATTC	unknown
TCTTGGAGACGTCTACCTTC	unknown
TGAACCGGTGCCGAGCGATT	GTGAGTCTGTCTCTGTCTCTCTGTCTGT
TGAACCGGTGGTAATACGTC	unknown
TGAACCGGTGTCTTGGAGAC	unknown
TGAAGCAACCAGAATTCAGT	unknown
TGAAGGAAGGAAGATTAACC	unknown
TGAAGGAAGGTTCGCATAAT	unknown
TGACACGTTAACGACTATTA	unknown
TGACACGTTAGAGACAACGG	GTGTGAGTGTGACTCTGAGAGACTCTCT
TGACCGCGCGCATCAGTTGG	ACTCAGAGAGTGACTGTGACTCTGTCTG
TGACGACCAAACTACGGTCG	unknown
TGACGTCTGATCTTCATCTC	GTGAGTGACACAGTGTGAGGGTCTGTCA
TGACTATCGAAGCACAGTTG	ACTCAGAGAGTGACTGTGACTCAGTCTG
TGACTATCGAGATGGAGTGC	unknown
TGACTATCGAGGCCTGCACA	TGTCTCTGTGTCTGAGAGAGTCTGTCAG
TGACTGTCAGTTAACGTAGG	unknown
TGAGACCGGTTCATCGGATT	unknown
TGAGACCGGTTCTTGGAGAC	unknown
TGAGCATAACGCCTCTGGCT	unknown
TGAGCCGCGCCATCGGCATG	unknown
TGAGCGGCCGCGCGACGAGG	CGTGAGTCTGACTCTG
TGAGGAGGAACTTCCATCCT	unknown
TGAGGCGGCCACACACCAGA	unknown
TGAGGTGGTTCATCAATTAA	unknown
TGAGTAGCATCGAGGTTAAC	GACTCAGCGTAGCAGTCAGAGACTGTGA
TGAGTCTAGTAGAGAGTCGC	GTGAGTGAGTCTCAGTGACTCTCAGAGT
TGAGTCTAGTCGCCTCTCGG	unknown
TGAGTCTAGTGCTAGTAGAA	unknown
TGAGTGGTTGCTAGACACTT	unknown
TGAGTGGTTGTTAACGTAGG	GTCACACTGTCTCTGTCTCAGTCAGAGA
TGAGTGGTTGTTAACGTAGG	GTCACACTGTCTCTGTCTCAGTCAGAGA
TGAGTGGTTGTTAACGTAGG	GTCACACTGTCTCTGTCTCAGTCAGAGA
TGAGTTGTGTGGCTATATAA	ACTCAGAGAGTGACTGTGACTCTGTCTG
TGAGTTGTGTGTTGTCTGAC	unknown
TGATAGCATGCGCGACGAGG	unknown
TGATAGCATGTCCTCGTGCG	unknown
TGATCGAGGTACGACTATTA	unknown
TGATCGAGGTTCATCGGATT	GACGTGTCACTCTGTGTGTCTGTCACTG
TGATCGAGGTTCATCGGATT	GACGTGTCACTCTGTGTGTCTGTCACTG
TGATCGAGGTTCATCGGATT	GACGTGTCACTCTGTGTGTCTGTCACTG
TGATCTAGTGCATTCCGGCT	AGAGAGTCTCACTGTCAGTGACTGACTG
TGATCTAGTGGGAACGTGCC	unknown
TGATGACGTACGATTGATAA	CACTCAGAGAGTGACT
TGATGACGTACGATTGATAA	ACTCAGAGAGTGACTGTGACTCTGTCTG
TGATGACGTACGATTGATAA	CACTCAGAGAGTGACTGTGACTCTGTCT
TGATGATTAACTTGACTCAA	unknown
TGATGATTAAGCTGTGAGAC	unknown
TGATGTCGATGCCTCCGGTC	unknown
TGATTACCTTATCAGTTAAC	unknown
TGATTACCTTCTTGTCTAGT	CGTGAGTCTGACTCTGTCTCTCTGACT
TGATTACCTTGGCTCCAAGC	unknown
TGCAACCGGACTTGTCTAGT	unknown
TGCAACCGGAGGCTCCAAGC	unknown
TGCAACCGGAGTGCGAACAT	GTCTCTGTCTCAGTGAGTGTCTGACACA
TGCAAGATACACCTCTCCTG	unknown
TGCAAGATACCTCACCTAAG	unknown
TGCAAGATACGCAACTATTG	unknown
TGCAAGATACGGCTCCAAGC	TCGTGTGAGTGTGACTCTGAGAGACCCT
TGCAAGATACGGCTCCAAGC	GTGTGAGTGTGACTCTGAGAGACTCTCT
TGCAAGATACGGCTCCAAGC	GTGTGAGTGTGACTCTGAGAGACTCTCT
TGCACTGTCTCATATTAGGA	unknown
TGCAGTGGTAAGCAAGCGAC	CGTGTGAGTGTGACTCTGAGAGACTCA
TGCAGTGGTAAGCAAGCGAC	GTGTGAGTGTGACTCTGAGAGACTCACT
TGCAGTGGTACGCCTCTCGG	AGTGAGTGTCTGACTGTCTGACTCTGTG
TGCAGTGGTACGCCTCTCGG	AGTGAGTGTCTGACTGTCTGTCTCTGTG
TGCAGTGGTACTCTAAGCAT	GTTTGTGTCTGTGTCACTGTCTGTCTCA
TGCCTGCCTCAGCAAGCGAC	GTCTCTGACTCAGTGAGTGTCTGACACA
TGCCTGCCTCAGCAAGCGAC	GTCTCTGACTCAGTGAGTGTCTGACACA
TGCCTGCCTCAGCAAGCGAC	CGTCTCTGACTCAGTGAGTGTCTGACAC
TGCGAGCTCTCGTACCGCGA	CGACTCAGAGTTACAGTCAGA
TGCGAGCTCTGATGAGAGGT	GTGAGTGAGTCTCAGTGACTCTCAGAGT
TGCGAGCTCTGATGAGAGGT	GTGAGTGAGTCTCAGTGACTCTCAGAGT
TGCGGTTACGCTTGACTCAA	GTCTCTGACTCAGTGAGTGTCTGACACA
TGCTCAGAAGGTTCGCGCGC	TGTCTCTGTGTCTGAGAGAGACTGTCAG
TGCTCTATTCTATCGCGCCA	unknown
TGCTGCAGTACATCAGTTGG	unknown
TGCTGCAGTATCAATGGTGG	unknown
TGCTGCTGCGGACCAGTACG	unknown
TGCTGCTGCGTACCATGACT	AGTGAGTGTCTGACTGTCTGACTCTGTG
TGCTGGTGGCCGCCTCTCGG	unknown
TGGACGTGACCAGCGAAGTC	unknown
TGGACGTGACTATCGCGCCA	CGTGTGAGTGTGACTCTGAGAGACTC
TGGAGAACTCATGGAAGGCC	unknown
TGGAGAACTCCCATAAGGAG	GACGTGTCACTCTGTGTGTCTGTCACTG
TGGAGAACTCGACTGTTCCT	CGTGAGTGAGTCTCAGTGACTCTCAGA
TGGAGAACTCGACTGTTCCT	GTCTCAGTGTCAGACACTGTCAGAGTGA
TGGAGAGAGGGCACTTCACG	GTGTGAGTGTGACTCTGAGAGACACTCT
TGGAGAGAGGGCACTTCACG	CGTGTGAGTGTGACTCTGAGAGA
TGGAGAGAGGGCACTTCACG	GTGTGAGTGTGACTCTGGGAGACTCTCT
TGGAGAGAGGGCTTCTGTAC	TCAGTCACTGTCTGTGACTCAGTCTGTG
TGGAGAGAGGGGTATCCTTA	unknown
TGGAGCTCAGCATCGGCATG	unknown
TGGAGCTCAGCGCCTCATCT	GTGTGAGTGTGACTCTGAGAGACTCTCT
TGGATTAGACTACTAATGGC	unknown
TGGCAATTGCCTCAAGTCGC	unknown
TGGCAATTGCTATTCATATA	unknown
TGGCAATTGCTTCAGTGCGG	GTGAGTCTGACTCTGTCTCTCTGACTGT
TGGCCAGTAAACATAGGTGG	unknown
TGGCCAGTAAGAGTAGATTG	GACTCAGAGTGTCTGTGACACACTCACA
TGGCCTTACCCTGCAGGATA	GTGTCTCTCTGACTGACTCTGTGTGTGT
TGGCTCAAGGACATAGGTGG	unknown
TGGCTCAAGGATGATCATTA	unknown
TGGCTGAACCCGGACTGAGG	unknown
TGGCTGAACCCTCACCTAAG	unknown
TGGCTGAACCTCTTGGAGAC	unknown
TGGTACTGCTATGTTCTATA	GACGTGTCACTCTGTGTGTCTGTCACTG
TGGTACTGCTGACCGTCTCT	unknown
TGGTATTGTCAGTCGACCAT	GTGAGTCTGACTCTGTCTCTCTGACTGT
TGGTATTGTCCTTACCGGTG	unknown
TGGTATTGTCGGCCTGCACA	unknown
TGGTATTGTCTGCGGTTACG	unknown
TGGTTCCACTCGGCGATACC	unknown
TGGTTCCACTCTGTGAGCAG	unknown
TGGTTCGGACAGATTGCTCA	unknown
TGTAATCCATGCAGGTATCC	unknown
TGTACTGGACGAACGCCGTG	unknown
TGTAGAGTCCTACGCCGATT	unknown
TGTAGCGTAAAGACCGTCGT	GTCTGTCTCTCTGTCAGAGTGTGTCTCA
TGTAGCGTAAAGTCGACCAT	unknown
TGTCCGCGATATAGAGAGCC	unknown
TGTCCGCGATCCGTGCAACC	GACGTGTCACTCTGTGTGTCTGTCACTG
TGTCCGCGATCGATAAGCAC	GACTGTGTCACAGAGTCACAGTCTCCCT
TGTCCTACCTGATATAGCGG	unknown
TGTCGTAGGTAATTCCAACC	unknown
TGTCGTAGGTAGTGGTGGTA	unknown
TGTCGTAGGTGATTCAGAGA	unknown
TGTCTACGCGTTCTATCAGC	unknown
TGTCTCATCCATACTCCTAC	unknown
TGTCTGTCCTCTATCGCCTT	unknown
TGTCTGTCCTTGTTCCAGAC	GTGTCAGTGTCAGACACTGACAGAGTGA
TGTCTTACGAAGACTTACGT	CGTGTGAGTGTGACTCTGAGAGA
TGTCTTACGAGGACACTCTT	unknown
TGTGTGTAACCAATCTCATG	unknown
TGTGTGTAACCTCACTGTAG	unknown
TGTTCACTAGTCCTGGTCGG	CGTGTGAGTGTGACTCTGAGAGACTCTC
TGTTCACTAGTCCTGGTCGG	GTGTGAGTGTGACTCTGAGAGACTCTCT
TGTTCCAGACCGTTCAATAA	GTGTGAGTGTGACTCTGAGAGACTCTCT
TGTTCTCCGGGCTAGTAGAA	unknown
TGTTGTCGCGTAGTTAGACG	unknown
TTAACCGCGAGCCAGCACGT	unknown
TTAACCTACCCTCGCAGGTC	unknown
TTAACCTACCGGCACTGAGC	ACTCAGAGAGTGACTGTGACTCAGTCTG
TTAACGTAGGATGATCATTA	unknown
TTAATTGCTCATGGCGTGCG	unknown
TTAATTGCTCTATCGGAATA	unknown
TTACCAAGGTAACGAGTATT	TGTGAGACAGTCACAGTGTGTCTGTCTG
TTACGAACCTATCGAGCGAA	unknown
TTACGAACCTGATGAGAGGT	unknown
TTACGAACCTGGCACTGAGC	GTGAGTGACACAGTGTGAGAGTCTGTCA
TTACGATTGGATCAGAGTCA	GTGAGTGACACAGTGTGAGAGTCTGTCA
TTACGATTGGATCAGAGTCA	GTGAGTGACACAGTGTGAGAGTCTGTCA
TTACGATTGGATCAGAGTCA	CGTGAGTGACACAGTGTGAGAGT
TTACGATTGGCGTTCGATGG	unknown
TTACGATTGGTCCGAAGATT	unknown
TTACGTTCAGTGTCAGGCAC	unknown
TTACTATGTGGTCGCGATTC	GTGTCTGTCTCAGACAGAGTGTCAGACA
TTACTATGTGGTCGCGATTC	CGTGTCTGTCTCAGACAGAGTGTCAGAC
TTACTGCTGAAGCAGGCAGC	unknown
TTACTGCTGAGGAGGTTGGT	unknown
TTATCAATAACTTCGATGGT	GAGTGACTGTCAGTGTGAGAGTGTCAGA
TTATCAATAAGCCAGCACGT	unknown
TTATCGATGGCAACTCGTCG	unknown
TTATCGATGGGCGCAGCACC	unknown
TTATGACCGGCTGACCTGGT	unknown
TTATGGCCAACCATAAGGAG	CGTGTGAGTGTGACTCTGAGAGA
TTATGGCCAACGTATTGCTC	unknown
TTATGGCCAAGACATCGGTG	GTCTCTCAGTCAGAGACTCACACTCAGT
TTATGGCCAAGACATCGGTG	GTATCTCAGTCAGACTCACACTCAGTGT
TTATGGCCAAGACATCGGTG	GTCTCTCAGTCAGAGACTCACACTCAGT
TTATGGCCAAGTTACGCGTC	GTGTGAGTGTGACTCTGAGAGACTCTCT
TTATGGCCAAGTTACGCGTC	GTGTGAGTGTGACTCTGAGAGACTCTCT
TTATGGCCAATATGGCATAG	GACGTGTCACTCTGTGTGTCTGTCACTG
TTATGGTGGTCCAGATTCGG	unknown
TTATGGTGGTCCGGTCACTA	unknown
TTATGGTGGTCGATACTAGC	CGTATGTCTCTCTGTCAGAGTGTGACTC
TTATGGTGGTCGATACTAGC	CGTGTGTCTCTCTGTCAGAGTGT
TTATGGTGGTTTCTCACTCC	CGTGACTGTCAGTCTCTGAGGTCTGA
TTATTCACTCGATAATGATG	unknown
TTATTGCGATACATATGCGA	GTCTCTCAGTCAGAGACTCACACTCAGT
TTATTGCGATCTTCGGCCGG	GAGAGACTGTCACTGTCTCTGACACTGT
TTATTGCGATTGGAGCTCAG	unknown
TTATTGGACCCATATTAGGA	unknown
TTATTGTCGAACGCCTCAGT	unknown
TTCACTGGCGACGACAATAT	unknown
TTCACTGGCGCGATAAGCAC	unknown
TTCAGCAACTCGATATGTGC	unknown
TTCAGCAACTTCCTGGTCGG	unknown
TTCAGTGCGGCAGCGAAGTC	ACTCTCACACTCTCTCTGTCAGTCTCAG
TTCAGTGCGGCATCAATTAA	unknown
TTCAGTGCGGCTCACAGCGG	ACTCAGAGAGTGACTGTGACTCTGTCTG
TTCAGTGCGGCTCACAGCGG	ACTCAGAGAGGGACTGTGACTCTGTCTG
TTCAGTGCGGTTGAAGAAGC	unknown
TTCCAATAACATGCGAGCGT	unknown
TTCCAATAACCGAATATAGG	unknown
TTCCATGTCAAGCAGGCAGC	unknown
TTCCATGTCAGATATGGCAA	unknown
TTCCATGTCAGTTACCACAT	unknown
TTCGAATCCTCCTGCTTAGT	unknown
TTCGAATCCTGTTGTTCTCT	unknown
TTCGAATCCTTACGCCGATT	unknown
TTCGACCGGCCGCACTGGAT	unknown
TTCGACCGGCGAGGTGCCGC	unknown
TTCGACCGGCGCCGCAATAG	unknown
TTCGAGATAAAGGCACACCT	unknown
TTCGAGATAAGCTGCTCTTC	unknown
TTCGCCGCGTGCTCAGCTGG	ACTCTCACACTCTCTCTGTCAGTCTCAG
TTCGCCGCGTGCTCAGCTGG	ACTCTCACACTCTCTCTGTCAGTCTCAG
TTCGCCGCGTGTTACGCGTC	unknown
TTCGGCGGCTATTAAGATAA	TGTCAGTGTGTCTGTCTGTGAGTCTCTG
TTCGGCGGCTTGATGACGTA	unknown
TTCGTCGCCATCCTCGTGCG	unknown
TTCGTCTAGCTTACTGCCTT	unknown
TTCGTGAATAACGGTACCTC	unknown
TTCGTGAATAAGAATTCAGT	unknown
TTCGTGTACGCTCAACATGT	unknown
TTCGTGTACGTGTTCCAGAC	CTCAGTCACAGTCTGT
TTCGTTGTGCGCTTAGTCGG	GACGTGTCACTCTGTGTGTCTGTCACTG
TTCTATCAGCGTTGCGCCGG	unknown
TTCTCACTCCAGTGGTGGTA	unknown
TTCTCCAGCGTGCTGCAGTA	unknown
TTCTCGAGGCCCGGTCACTA	unknown
TTCTCGAGGCGATGGAGTGC	unknown
TTCTGCACGGACGGCGAGGC	unknown
TTCTGCTTCTCAAGCTGAAG	unknown
TTCTGCTTCTGTAGTTCTAG	unknown
TTCTGCTTCTGTCGTCGATC	unknown
TTCTGCTTCTGTTCGCGCGC	CTCACACACTGAGACACACTCTGAC
TTCTGTCGACTTCTCCTGTA	GTGTGTCTGTGTGTCTGTGTGACTGTGA
TTCTGTGACTGCGGTGCAGA	AGTGAGTGTCTGACTGTCTGACTCTGTG
TTCTGTGACTGCGGTGCAGA	AGTGAGTGTCTGACTGTCTGACTCTGTG
TTCTGTGACTGGAGGTCCAA	GACTCAGAGTGACAGTCAGAGACTGTGA
TTCTGTGACTGGAGGTCCAA	GACTCAGAGTTACAGTCAGAGACTGTGA
TTGAATGCGTATAGCTGGAT	AGTGAGTGTCTGACTGTCTGACTCTGTG
TTGAATGCGTATAGCTGGAT	GACGTGTCACTCTGTGTGTCTGTCACTA
TTGAATGCGTATAGCTGGAT	GACGTGTCACTCTGTGTGTCTGTCACTA
TTGAATGCGTGCAACTATTG	unknown
TTGAATGCGTGCCTCTGGCT	GTGACACTGTCTCAGAGACTGACAGAGA
TTGACATCTCTATAGAAGCT	GTGCAGTCACAGTGTGACACTGTCTGTG
TTGACTCGGCAGTGGACACC	GTGTGAGTGTGACTCTGAGAGACTCTCT
TTGACTCGGCGACTCTCCAA	unknown
TTGAGCCTGAGTTACGCGTC	unknown
TTGAGGAGACAGACCGATCG	unknown
TTGAGGAGACAGTGTTGCTT	CGTCTCTCAGTCTGTGACTCACA
TTGAGGAGACATATTCTCAC	unknown
TTGAGGAGACGGACACTCTT	unknown
TTGATAGATTAAGGAATGTA	GTGTGTCTGTGTGTCTGTGTGACTGTGA
TTGATAGATTGATTGATGGC	CTGTGAGACTGTGTGAGAGTGA
TTGATATTCCAATACTCGAT	GAGTGACTGTCAGTGTGAGAGTGTCAGA
TTGATATTCCAATACTCGAT	CGAGTGACTGTCAGTGTGAGAGTGTCAG
TTGATATTCCAATACTCGAT	CGAGTGACTGTCAGTGTGAGAGTGTCA
TTGATATTCCAATACTCGAT	GAGTGACTGTCAGTGTGAGAGTGTCAGA
TTGATATTCCGCGCAGCACC	unknown
TTGATATTCCGCTGTGAGAC	ACTCTCACACTCTCTCTGTCAGTCTCAG
TTGATATTCCGGACACTCTT	CGTCACACACTCACTGAGTGTCAGTGA
TTGCAGCCGCACGTTGAATA	unknown
TTGCAGCCGCCTTGCCTACA	unknown
TTGCAGCCGCGACGAAGACT	unknown
TTGGTAAGTTAAGATCAATT	GTGAGTGAGTCTCAGTGACTCTCAGAGT
TTGTACACGTAGGAGCTCCA	GACTCAGAGTCACAGTCAGAGACTGTGA
TTGTACACGTAGGAGCTCCA	AGGACGACTCAGAGTTACAGTCAGAGAC
TTGTACACGTAGGAGCTCCA	GACTCAGAGTCACAGTCAGAGACTGTGA
TTGTCAGTGGCTTCCATCCT	unknown
TTGTCAGTGGCTTGTAGCAT	GACTGTGAGTCACTCACTGTCACTCTCT
TTGTCGGTAAACGGCGAGGC	CGACTCAGAGTCACAGTCAGAGACTGTG
TTGTCTGCAGGACCAGAATA	unknown
TTGTCTGCAGGACTCTCCAA	GAGTGTGACTGTGTCTCAGAGACTGAGA
TTGTGGCATCAAGTAAGCGT	CGTGACACTGTCTCAGAGACT
TTGTGGCATCAAGTAAGCGT	GTGACACTGTCTCAGAGACTGACAGAGA
