Cell barcode	SW
AACAGACGACCAAGCTGAAG	unknown
AACAGAGACTTAGTTAGACG	unknown
AACAGCATAGACTACGGTCG	unknown
AACAGCATAGCTCTCCATAG	unknown
AACATTCCTCCCGAGCGATT	GAGACTGTGTCTGTGTCAGTCTCTCTCA
AACATTCCTCCCGAGCGATT	GAGACTGTGTCTGTGTCAGTCTCTCTCA
AACATTCCTCCTAGTGTAAC	GAGTGAGACTGTCAGACTGTCTGTCAGA
AACCATATACCAAGCTGAAG	unknown
AACCATATACTACTCAGGAA	CGACTCTCTGACACTCTGTCAGTC
AACCATATACTCCGACCGTA	unknown
AACCATATACTTCGCATAAT	unknown
AACCTAGTAGGCAACAGAAC	unknown
AACCTAGTAGTTGTGGCATC	unknown
AACCTGGTGAACGCCTCAGT	unknown
AACCTGGTGAAGTGTTGCTT	AGTGTCACAGAGAGTCTCTGACTCAGAG
AACCTGGTGAAGTGTTGCTT	CAGTGTCACAGAGAGTCTCTGACTCAGA
AACCTGGTGAAGTGTTGCTT	CAGTGTCACAGAGAGTCGCTGGCTCAG
AACCTGGTGAATTAAGATAA	AGTGAGTGTCAGAGACTCTGTCTGACAG
AACCTGGTGACTTCCATCCT	CCGACACTCTGTGACTGACTGTCTCAC
AACCTGGTGAGTCACGTGCT	unknown
AACCTTGCGGAGACCGTCGT	unknown
AACCTTGCGGCATGGACTCC	TGTCACTGTGTGTGTGTGACACTCTGAG
AACCTTGCGGTATCGCGCCA	unknown
AACCTTGCGGTGACTTCGTA	unknown
AACGAGGTCCCAGGAACGAG	unknown
AACGAGTATTCAGGAACGAG	GTCTCTGAGTCTGAGTCTGTCTGTGACT
AACGCAATTAGAACGCCGTG	GTGTGTCTGAGAGAGTCTCAGACAGAGA
AACGCAATTAGTTACGCGTC	unknown
AACGCATTCGCGTTCTACGA	unknown
AACGCATTCGGCGTTAGATG	unknown
AACGGTTGAGGGTATCCTTA	unknown
AACGTATCTGACAGTCCACC	unknown
AACGTATCTGACGGCCTGTA	unknown
AACGTCACACTCGACATCGA	unknown
AACTGAGCGGGTCCAGACGA	TGTCTCAGTCTGTCACACTCACTGAGTG
AACTGAGCGGGTGAACGAGA	unknown
AACTGAGCGGTGTGTGTAAC	unknown
AAGAAGTCACTATCATCTCT	unknown
AAGACCTAGGGATGAGAGGT	unknown
AAGACGTACCCTCAACATGT	CGTGTCAGAGACAGAGTGTGTCTG
AAGACTGTGGAATTAATCTG	unknown
AAGACTGTGGGTACATAGGC	unknown
AAGATCAATTAACCTTGCGG	unknown
AAGATCAATTCAGGAACGAG	unknown
AAGATCAATTGGTGCAACCT	unknown
AAGATTAACCTGAGGTGGTT	AGTGTCACAGAGAGTCTCTGACTCAGAG
AAGATTAACCTGTTCCAGAC	unknown
AAGCCTTGACACATGCCTGT	unknown
AAGCGATTCCCTAGGCCACG	unknown
AAGCGATTCCTGACTTCGTA	unknown
AAGCGCCGTAGATGGAGTGC	unknown
AAGCGCCGTAGCGTACAACT	TGTCTCACTGAGAGTCTGTGTGTGTCTG
AAGCGCCGTAGCGTACAACT	TGTCTCACTGAGAGTCTGTGTGTGTCTG
AAGCGCCGTAGCGTACAACT	TGTCTCACTGAGAGTCTGTGTGTGTCTG
AAGCGCCGTATTCAGTGCGG	unknown
AAGCGCTTAAACGACAATAT	unknown
AAGCGCTTAAGTTAAGGTGA	unknown
AAGGAACTAACTGACCTGGT	unknown
AAGGAATGTACAAGCTGAAG	unknown
AAGGACCTCCAGAGCGGCAA	AGTGAGAGTCAGAGACTCGGTCTGACAG
AAGGAGCTGGCATTCCGGCT	unknown
AAGGAGCTGGCCAGATTCGG	unknown
AAGGAGCTGGCTTACCGGTG	unknown
AAGGATTGATAATCTACAAG	unknown
AAGGATTGATGCCGGTTGTA	unknown
AAGGATTGATTTACTGCCTT	GTTTGTGACAGTCTGTCTGAGTCTGTCT
AAGGATTGATTTACTGCCTT	GTCTGTGACAGTCTGTCTGAGTCTGTCT
AAGGTACATACTTCCTACAG	unknown
AAGGTTCAATAACCTTGCGG	unknown
AAGGTTGGCCCCGTGCAACC	unknown
AAGGTTGGCCCGATTGATAA	unknown
AAGTAAGCGTCGATATGTGC	unknown
AAGTAAGCGTGATATGGCAA	unknown
AAGTCACGGCATGGCGTGCG	unknown
AAGTCACGGCGTGGCAGGTG	unknown
AAGTCACGGCTCCAGGTACT	unknown
AAGTCCTCCTCGCGACGAGG	unknown
AAGTCCTCCTGGAGGTTGGT	unknown
AAGTCGATCCTTGAAGAAGC	unknown
AAGTGCTGGTATGACGGATA	unknown
AAGTTCGACCGCGAACACGG	unknown
AAGTTGGAGGCAGTCCAGGA	unknown
AAGTTGGAGGGTCTCACAGT	unknown
AAGTTGGAGGTCCAATAGAA	unknown
AATACATTAAATGATCATTA	unknown
AATACCGATTCGGACTGAGG	unknown
AATACCGATTGGAGGTTGGT	unknown
AATACCTTCCGCCAGCACGT	unknown
AATACCTTCCGCTTAGTCGG	unknown
AATACCTTCCTAGAAGACTC	unknown
AATACGACCTGGTGCAACCT	unknown
AATACGTTGGCTTGCCTACA	unknown
AATACTCGATCATAGGACTG	unknown
AATAGTAGTGGTTCGCGCGC	unknown
AATAGTTGCAGGCTTCGTCG	GTGTGTCACAGAGTGTGTCTCTCACTCT
AATAGTTGCAGGCTTCGTCG	AACGTCTGTCACAGAGTGTGTCTCTCAC
AATAGTTGCATCCGTGAAGC	unknown
AATATTATGGCCTTAAGGCT	AGTGAGTGTCAGAGACTCTGTCTGACAG
AATATTATGGCCTTAAGGCT	CGACTGTGTCTCTGAC
AATATTATGGCGATACTAGC	unknown
AATCAACTTGATTATTGTGC	unknown
AATCAACTTGGGAGGTCCAA	unknown
AATCACAGTCGACCAGTACG	unknown
AATCACAGTCGCTTCTGTAC	unknown
AATCACAGTCGGCCTGCACA	TCGACTGTGACTCTGACAGTGAGTCTGT
AATCCGCACTTGGATTAGAC	unknown
AATCGATAGGATCAGTTAAC	unknown
AATCGATAGGCGATTGATAA	unknown
AATCGATAGGGGAGTACGTA	TGACACTCTGTGACTGACTGTCTCACTG
AATCGCGCAGCGAATATAGG	unknown
AATCGCGCAGGGAGCTATGG	GACAGACAGTCACACTGAGAGTCAGTGT
AATCTACAAGACGCCTCAGT	GTCACTGAGTGAGACAGTGTGACTCACT
AATCTACAAGCGAATATAGG	unknown
AATCTACAAGCTAGTGTAAC	unknown
AATCTACAAGGAGACAACGG	AACGACTGTGTCTCTGACAGTCTCAGAG
AATCTACAAGGTCCAGACGA	unknown
AATCTACAAGTCCGAAGATT	unknown
AATGCGCCACAACTTGCACC	unknown
AATGCGCCACCTTACCGGTG	unknown
AATGCGCCACTGGAGCTCAG	unknown
AATGGAATACACTGCACAGG	unknown
AATTACACACCGACGGACGA	unknown
AATTACACACCTTCAATAAT	unknown
AATTACACACGTCGGACCTC	unknown
AATTCCAACCTGTGTGTAAC	unknown
AATTCGAAGGCGTCCGCTCT	unknown
AATTCGAAGGTCGACATCGA	unknown
AATTCTAATTATAGAGAGCC	unknown
AATTCTAATTGAACGAATTC	unknown
AATTGCGGTGACATATGCGA	unknown
AATTGCGGTGCGAGGAGTCA	unknown
ACACACCAGACAGCAAGCAG	TGTCTGACACTGAGACAGTCACAGTCTG
ACACCTTGTCACTTCAACAC	unknown
ACACCTTGTCATGTCCGTGC	unknown
ACACCTTGTCCAAGCTGAAG	unknown
ACACCTTGTCTCAATGGTGG	TCACTCTTCTCACTGTCAGAGACAGTGT
ACACCTTGTCTCAATGGTGG	TCACTCTTCTCACTGTCAGAGACAGTGT
ACACCTTGTCTGTGTAGCCG	unknown
ACACGAGAATCGCCTCATCT	unknown
ACACGCCGAAACCGACATTA	unknown
ACACGCCGAAGCTTCTGTAC	unknown
ACACGCCGAAGGAGGTTGGT	unknown
ACACTGAGTCCATCGGCATG	unknown
ACAGAACTTAAAGGAATGTA	unknown
ACAGAACTTAATGATCATTA	unknown
ACAGAATGAAGTTGTCTGAC	unknown
ACAGATCTATGGCTCCAAGC	unknown
ACAGATCTATGTTGTCTGAC	unknown
ACAGATCTATTACTCAGGAA	unknown
ACAGATCTATTATGGCATAG	CGTGACTGACTGTGTGTCTCT
ACAGATTGTTCGTACCGCGA	unknown
ACAGGATAGATATTCATATA	CTGTCTCACTGAGAGTCTGTGTGTGT
ACAGTCCACCCGATTCCGGC	unknown
ACAGTTCATTATTAACCGGC	unknown
ACATAAGTAATAGGCTCAGG	unknown
ACATACGTCCGGAACGTGCC	unknown
ACATAGGTGGTACTAATGGC	unknown
ACATATGCGACTTCTTCGTA	unknown
ACATATGCGAGTCCAGACGA	unknown
ACATCATTGCCCACTGGATT	unknown
ACATCATTGCGTCACGTGCT	GCGAGACTGTGTCTGTGTCAGTCTCTCT
ACATCATTGCTGTTCACTAG	GTGTGAGTGTGACTCTGAGAGACTCTCT
ACATCTTCACCTCGATTGGT	unknown
ACATCTTCACGAGGTGCCGC	unknown
ACATCTTCACTGTGTAGCCG	unknown
ACATGCCTGTAAGTTGGAGG	ACTCTGTGTGAGTGTGTCACACTCTGTG
ACATGCCTGTCGTACCGCGA	TGTCTGTGAGAGACTCTCTGAGTCTCTG
ACATTAGATAAATTAATCTG	unknown
ACATTAGATAATAGCTGGAT	unknown
ACATTAGATAGTCACGTGCT	unknown
ACATTAGATATGGATTAGAC	unknown
ACCAAGCCAGAGCAGGCAGC	unknown
ACCAAGCCAGGAACGCCGTG	unknown
ACCAAGCCAGTGATGACGTA	CTGTCTGACACTGAGACAGTCACAGT
ACCAATAGCGAAGATCAATT	unknown
ACCAATAGCGTCCGAAGATT	TCACTGACAGAGAGTGTGACTCACAGAG
ACCAATCTAACGCGACGAGG	unknown
ACCAATCTAATCAGATAGAT	unknown
ACCAATTGTAATAACATACG	unknown
ACCAATTGTAGATTCAGAGA	unknown
ACCAGCGCATATTACCGCGT	unknown
ACCAGCGCATGATATAGCGG	unknown
ACCAGCGCATTAATCGGTGC	CTCACTGACAGAGAGTGTGA
ACCAGCGCATTATGAACAGC	unknown
ACCAGCGCATTCGTAGTCGT	GAGTCACCTCTGTGTGTCTCAGAGACTG
ACCATACAATCGTTCGATGG	unknown
ACCATAGGCCACATGCCTGT	unknown
ACCATTCATAAAGTCGATCC	unknown
ACCGACATTACGGCGATACC	unknown
ACCGACATTAGGCTTCGTCG	unknown
ACCGACTTCGATGACGGATA	unknown
ACCGACTTCGGTCCAGACGA	unknown
ACCGATGACGAGTCTATCGT	CGACTCTCTGTGAGTGTGTGACTCTCTC
ACCGATGACGCGGACCACCT	GAGACTGTGTCTGTGTCAGTCTCTCTCA
ACCGATGACGTGACGTCCTT	unknown
ACCGCGGTAAATCAGTTAAC	unknown
ACCGCGGTAACGCCTCTCGG	unknown
ACCTACGGCGAGGTTAGGAG	unknown
ACCTACGGCGGACTGTTCCT	unknown
ACCTACGGCGGCTTAGATCT	unknown
ACCTCGTGAAATCAGAGTCA	unknown
ACCTCGTGAAGCTAGTAGAA	unknown
ACCTCTCCTGTCACGAATCC	unknown
ACCTGAACTAAGTCTATCGT	unknown
ACCTGAACTACACTCAGTCA	unknown
ACCTGAACTACTCACAGCGG	unknown
ACCTGAACTATCCAATAGAA	unknown
ACCTGATCCGTCTTCATCTC	CGAGACACTCTCTCTGTGTGAGAC
ACCTTAAGTTACTACGGTCG	unknown
ACCTTAAGTTGCGTTAGATG	unknown
ACGACAATATACCAAGCCAG	unknown
ACGACAATATGAGTAGATTG	unknown
ACGACCGACGATGATCATTA	unknown
ACGACCGACGGTATTGGCTA	unknown
ACGACCGACGTTCAGTGCGG	unknown
ACGACGACTGCAAGCTGAAG	unknown
ACGACGACTGCATCGGCATG	unknown
ACGACGTCCAACCAATCTAA	unknown
ACGAGGCCATAGACCGTCGT	unknown
ACGAGGCCATCATGGACTCC	unknown
ACGAGGCCATTAGGCTCAGG	unknown
ACGAGGCCATTATCGCGCCA	unknown
ACGAGGCCATTGACTTCGTA	unknown
ACGAGGTGGACGTATCGCCT	unknown
ACGAGTAGCTAACAGCATAG	GACTCTCTGTGAGTGTGTGACTCTCTCT
ACGAGTAGCTGTAGTTCTAG	unknown
ACGAGTAGCTTAACAGCCAA	unknown
ACGAGTAGCTTCTTGGAGAC	unknown
ACGATGATCGACATGCCTGT	unknown
ACGATGATCGTGGAGCTCAG	unknown
ACGATGATCGTTACCAAGGT	unknown
ACGATGCGAAAGGCACACCT	unknown
ACGATGCGAACATGGACTCC	unknown
ACGATGCGAATTGATCTTAA	unknown
ACGATGTCGTCCTGCGAACA	unknown
ACGATTACCAGCTGCTCTTC	unknown
ACGATTACCATAACATAGCA	GAGACTGTGTCTGTGTCAGTCTCTCTCA
ACGCATTGCAACGACTATTA	unknown
ACGCATTGCACCATCGTGAC	unknown
ACGCATTGCACTCAAGTCGC	unknown
ACGCCTCAGTTATTACTCTC	unknown
ACGGATCAGCGGCTTCGTCG	unknown
ACGGCACTCCTATAGAAGCT	CTCACTCTTCTCACTGTCAGAGAC
ACGGCACTCCTATAGAAGCT	CTCACTCTTCTCACTGTCAGAGACAGTG
ACGGCACTCCTTACTGCCTT	CTGACACTCTGTGACTGACT
ACGGCCAGCGCATATTAGGA	unknown
ACGGCCAGCGGATTGATGGC	unknown
ACGGCGAGGCAGTGGTGGTA	unknown
ACGGCGAGGCTACTAATGGC	unknown
ACGGTACCTCAGCAAGCGAC	unknown
ACGGTACCTCCCATAAGGAG	GAGACTGTGTCTGTGTCAGTCTCTCTCA
ACGTAATCCTTTCAGTGCGG	unknown
ACGTAGATAAACTGGTAAGA	unknown
ACGTAGCGCGGGAGGTCCAA	unknown
ACGTAGCGCGGTAATTGACA	unknown
ACGTATACAGCCAGATTCGG	unknown
ACGTATACAGTAGCGCACGT	unknown
ACGTATACAGTGGTATTGTC	CAGTGAGCGTCAGAGACTCCGTCTGA
ACGTCCGCGTCCGAGCGATT	unknown
ACGTCTTATACGTTCGATGG	unknown
ACGTGCGGCTCGTTCTACGA	GTGACTGTCTGTGACTCTCACAGTGTCA
ACGTGCGGCTCTATCGCCTT	unknown
ACGTGCGGCTTCACGAATCC	unknown
ACGTTAGCACACGTTGAATA	unknown
ACGTTAGCACCTCACCTAAG	unknown
ACGTTAGCACGCACATAGTA	unknown
ACGTTCGCCAAGCAAGCGAC	unknown
ACGTTCGCCAATGTCTGCCA	unknown
ACGTTCGCCAGCAGGTATCC	unknown
ACGTTCGCCAGTGCGAACAT	unknown
ACGTTCGCCATACGAAGTGC	unknown
ACGTTCTAGCTAGGCTCAGG	unknown
ACGTTGAATAATGGAAGGCC	unknown
ACGTTGTACGCCATCGTGAC	unknown
ACTAACCGTAGCTTAGTCGG	TGACACTGTCTGAGTGACTCAGTCAGAG
ACTAACTTAAATGGAAGGCC	unknown
ACTACCGTGCTTGACATCTC	unknown
ACTACGGTCGCGTTCGATGG	unknown
ACTACGGTCGTGGAGCTCAG	unknown
ACTACTGCCAAAGATTAACC	unknown
ACTACTGCCAAGGTTAGGAG	unknown
ACTATGGCTGGACCAGAATA	unknown
ACTCTGCCGCCGATATGTGC	unknown
ACTCTGCCGCCGTTCGATGG	unknown
ACTGATCTCGATCAGTTAAC	unknown
ACTGATCTCGTATCGGAATA	unknown
ACTGCACAGGAGTCGACCAT	unknown
ACTGCACAGGCTGCAGGATA	unknown
ACTGCACAGGGGCTATATAA	unknown
ACTGTCGGCGCGTTCTACGA	unknown
ACTGTCGGCGGTGCGAACAT	unknown
ACTTCAACACATCAGAGTCA	unknown
ACTTCAACACCTTGTCTAGT	unknown
ACTTCGGATAAGTTGTCGAA	unknown
ACTTCTATGCCGATTCCGGC	TCACTGACAGAGAGTGTGACTCACAGAG
ACTTGGTGTCAACCTTGCGG	GAGACTGTGTCTGTGTCAGTCTCGCTCA
ACTTGGTGTCTGTGTGTAAC	unknown
AGAAGATATAAACTTGCACC	GACTGACTCAAAGAGTCAGTGAGACTGT
AGAAGATATAAGGCACACCT	unknown
AGAAGCGTATAGAATTCAGT	unknown
AGAAGCGTATCGAATATAGG	unknown
AGAAGCGTATGGAGTACGTA	unknown
AGAATTCAGTACCTCTCCTG	unknown
AGACCGATCGCTTCTTCGTA	unknown
AGACCGATCGTACTAATGGC	unknown
AGACCGATCGTGTCAGGCAC	unknown
AGACCGCGAAAGATTGAGAG	CTGTGAGACTGTGTGAGAGTGG
AGACCGTCGTAGACTTACGT	unknown
AGACCGTCGTCAGCGAAGTC	unknown
AGACCGTCGTCGAATATAGG	unknown
AGACGGTGCTCATGGACTCC	unknown
AGACGGTGCTCTCAACATGT	unknown
AGACGGTGCTGGTTGGTAAC	TGTGACACTCAGTGTGTCTGTCACACAG
AGACGGTGCTGGTTGGTAAC	CGTCTGTGACCGTCTGTCT
AGACTAATATTACAGTACGC	unknown
AGACTCGACGAGACCGTCGT	unknown
AGACTCGACGTCGACATCGA	unknown
AGACTGGAGCCATGGACTCC	unknown
AGACTGGAGCTATTACTCTC	unknown
AGACTGGAGCTGAGGTGGTT	unknown
AGACTGGAGCTTAATTGCTC	unknown
AGACTGGAGCTTCAGTGCGG	unknown
AGAGACTCCGCGAGGTTAAC	TGTCTCACTGAGAGTCTGTGTGTGTCTG
AGAGACTCCGCGCCTCTCGG	unknown
AGAGAGGACAATAACATACG	unknown
AGAGAGGACAATAGAGAGCC	unknown
AGAGAGGACAGAGACAACGG	unknown
AGAGAGTCGCATGTTCTATA	unknown
AGAGCCTAAGCCATAAGGAG	unknown
AGAGCCTAAGGAGGTGCCGC	unknown
AGAGCCTAAGTCCAGGTACT	unknown
AGAGCGGCAACTGCAGGATA	unknown
AGAGCGGCAATTACCAAGGT	unknown
AGAGCTGTAGCACCGAGCAT	unknown
AGATCGCCTATATTCATATA	unknown
AGATCGCTGTACGCCTCAGT	unknown
AGATCGCTGTATTAAGATAA	unknown
AGATCGCTGTCAAGCTGAAG	GTGTCAGACAGTGTGGGTGAGTGAGTCA
AGATCGCTGTCGGACGGATT	unknown
AGATCGCTGTTGCTGCAGTA	unknown
AGATCTCTTGACATCATTGC	unknown
AGATCTCTTGCCATAAGGAG	unknown
AGATCTCTTGGGAGCAACAG	unknown
AGATCTTGAGAAGTCGATCC	unknown
AGATCTTGAGACGGCGAGGC	AGACAGACTCTCAGTGACAGAGACTGAG
AGATCTTGAGACGGCGAGGC	GACTCACACTGTGTGACAGTCAGAGAGT
AGATCTTGAGACGGCGAGGC	GACTCACACTGTGTGACAGTCAGAGAGT
AGATCTTGAGCGTTCGATGG	CGAGACTGTGTCTGTGTCAGT
AGATGTATATGGAGTACGTA	unknown
AGATGTATATTCTTCATCTC	CTGACAGAGTGTGTCACTGAGTC
AGATTAAGGAGGCTATATAA	unknown
AGCAACATGAAATCAGTGGA	unknown
AGCAACATGAGATATAGCGG	unknown
AGCAACATGAGATTCAGAGA	unknown
AGCAAGCGACAAGCGCCGTA	CGAGTGACAGTGAGTGTCTCTGAGTGTG
AGCAAGCGACCATCAATTAA	unknown
AGCACAGTTGCTATCACTAG	unknown
AGCAGCCACGGATTCAGAGA	unknown
AGCAGGCAGCATACCGAGCT	unknown
AGCAGGCAGCGACCAGTACG	unknown
AGCATGTAACCTTCCATCCT	unknown
AGCATGTAACGACATCGGTG	unknown
AGCATGTAACGACCGTCTCT	unknown
AGCATGTAACTCTGTTCATA	unknown
AGCCGCACCGATAGAGAGCC	GACTCTCCCTCTCTGTGTGAGAGAGTGT
AGCCGCACCGCTATCACTAG	unknown
AGCCGCACCGGGAGCAACAG	unknown
AGCCGCTCTAGACCGTCTCT	unknown
AGCCGCTCTAGATTCAGAGA	unknown
AGCCGGACGCAATTCGAAGG	unknown
AGCCGGACGCCGCACTGGAT	unknown
AGCCGGACGCTCCTGGTCGG	unknown
AGCGAACCTAATGTCTGCCA	unknown
AGCGAACCTACTCACTGTAG	unknown
AGCGAACCTAGTTACCACAT	unknown
AGCGAACCTATATAGAAGCT	unknown
AGCGAACCTATTCTCACTCC	unknown
AGCGAACTGTACATATGCGA	unknown
AGCGAGAGCTAGTAGTTACG	unknown
AGCGATCCATAATACTCGAT	unknown
AGCGATCCATCGTTCAATAA	unknown
AGCGCTGGACGCCAGCTTCG	unknown
AGCGCTGGACGCGACAGTGT	unknown
AGCGCTGGACTGGACGTGAC	GACTGTGACTCTGACAGTGAGTCTGTCT
AGCTATGCTTCCTTACCACA	unknown
AGCTATGCTTTCCTGGTCGG	unknown
AGCTCATCGCACATGCCTGT	unknown
AGCTGCCTTACTTCAATAAT	unknown
AGCTGCTGAAAATCAGTGGA	unknown
AGCTGCTGAAACACACCAGA	unknown
AGCTGCTGAAATAGAGAGCC	unknown
AGCTGCTGAACGCCTCATCT	unknown
AGCTTAGAGTACCAAGCCAG	unknown
AGCTTCCGGAATGGCGTGCG	unknown
AGCTTCCGGACCGGTCACTA	TGGACGACTCACACTGTGTGACAGTCAG
AGCTTCCGGACGATAAGCAC	unknown
AGCTTCCGGAGCACTTCACG	unknown
AGCTTCCGGAGTGCGAACAT	unknown
AGCTTGATACGTCTCACAGT	GTGACAGACTGTGACTCAGTACTGTGTG
AGGAACCACTAAGTAAGCGT	unknown
AGGAACGGACACTTCAACAC	unknown
AGGAACGGACATATTCTCAC	unknown
AGGAACGGACCGCTGAATTC	unknown
AGGAACGGACCTCACAGCGG	unknown
AGGACCTGGAATATTCTCAC	CGTGTGAGACTGGCAGACTGTCTGTCAG
AGGACCTGGAATATTCTCAC	CGAGTGAGACTGTCAGACTGTCTGTCAG
AGGAGCACTGGTAATTGACA	unknown
AGGAGCTCCACATCAATTAA	unknown
AGGAGCTCCAGTTGGATCCT	TCTCTGTGAGACAGTGACTCTGTCTGTG
AGGCACTTGGCGGCAGAGTC	unknown
AGGCAGTTCCCACATGTTAC	unknown
AGGCAGTTCCTCATCGGATT	unknown
AGGCAGTTCCTTAACCGCGA	unknown
AGGCCAGTCGAGTGTTGCTT	unknown
AGGCCAGTCGCATTCCGGCT	unknown
AGGCCAGTCGGACTATCACA	unknown
AGGCGCCATGGACATCGGTG	unknown
AGGCTAGCTGGCCAGCACGT	unknown
AGGTATAGACAGCCTCCTAT	unknown
AGGTATAGACCCGAGCGATT	GAGACTGTGTCTGTGTCAGTCTCTCTCA
AGGTATAGACGCTGCTCTTC	unknown
AGGTCGCAACAATAATGCAC	unknown
AGGTCGCAACAGGCACACCT	unknown
AGGTGTAAGCAGCAAGCGAC	GTGACAGTGTGAGACAGTCTCACAGTCT
AGGTGTAAGCAGTGGACACC	unknown
AGGTGTAAGCGACTTACTCT	unknown
AGGTTAGGAGGACCGTCTCT	GAGTCTCACTCTGTGTGGGAGGCCGTCT
AGGTTAGGAGGACCGTCTCT	GAGTCTCACTCTGGGGGGGGGGCCGTCT
AGTAAGCTCTGAGTAGATTG	unknown
AGTAAGCTCTGCCTCTGGCT	unknown
AGTAGTTACGTTCGCATAAT	unknown
AGTCATTATTCTTGTAGCAT	unknown
AGTCCAACTGCTTCAATAAT	GTGACAGTGTGAGACAGTCTCACAGTCT
AGTCCAACTGCTTCAATAAT	CGTGACAGTGTGAGACAGTCTCACAGT
AGTCCAACTGGCGGTGCAGA	unknown
AGTCCAGAGCGCCGGTTGTA	unknown
AGTCCAGAGCGTCTCACAGT	AGTGTGACAGAGTGTGTCACACTCTCAG
AGTCCAGAGCTGCGGTTACG	unknown
AGTCGACCATCTTGCCGCGC	CGTGACTGTCTGTGAC
AGTCGACCATGTGTGAAGTT	unknown
AGTCGATGGATCATCGGATT	unknown
AGTCGGCTTGCTATCACTAG	unknown
AGTCGGCTTGTACTCAGGAA	unknown
AGTCGGTGAGATGACGGATA	unknown
AGTCTACGAATCCTGATCAA	unknown
AGTCTATCGTTTACCAAGGT	unknown
AGTGAAGAGTCCGTGCAACC	AGTGTGTGTCTCACTGAGTCACCCTCTG
AGTGACCGGAATGGCGTGCG	unknown
AGTGACCGGAGACCAGAATA	unknown
AGTGACCGGAGACCAGTACG	unknown
AGTGACCGGAGGCCTGCACA	unknown
AGTGCCGTTCATACTGAGGA	unknown
AGTGCCTACTAATTCGAAGG	unknown
AGTGCTGTCTACGACAATAT	unknown
AGTGCTGTCTGGTTGGTAAC	unknown
AGTGGACACCAACGAGTATT	unknown
AGTGGTGGTAGACTCACCTT	unknown
AGTGGTGGTATGGACGTGAC	AGAGAGTCTCACTGTCAGTGACTGACTG
AGTGTGAATCCCGTGCAACC	unknown
AGTGTGAATCCGATTGATAA	unknown
AGTGTTGTGAGACCAGAATA	unknown
AGTGTTGTGAGCCGCAATAG	unknown
AGTTATCAGACTCAACATGT	unknown
AGTTATCAGAGTTGGATCCT	unknown
AGTTCACTCAAGAATTCAGT	GTGACAGTGTGAGACAGTCTCACAGTCT
AGTTCACTCAAGAATTCAGT	GTGACAGTGTGAGACAGTCTCACAGTCT
AGTTCACTCAAGGAGCTCCA	unknown
AGTTCCTGTCTAGCGCACGT	unknown
AGTTGACGTTGCACATAGTA	unknown
AGTTGACGTTTTAACGTAGG	unknown
AGTTGCGATAACAGTCCACC	unknown
AGTTGCGATAATCCACTAAG	GTGACAGTGTGAGACAGTCTCACAGTCT
AGTTGCGATAATCCACTAAG	GTGACAGTGTGAGACAGTCTCACAGTCT
AGTTGCGATACGATCACGAT	unknown
AGTTGCGATAGTTGGATCCT	unknown
AGTTGTATCGCATTCCGGCT	unknown
AGTTGTATCGCGCGAGTCGA	unknown
AGTTGTATCGTAGGCTCAGG	unknown
AGTTGTATCGTTGACATCTC	unknown
AGTTGTCGAACGATTGATAA	unknown
AGTTGTCGAACGTACCGCGA	unknown
AGTTGTTCGTTCGACATCGA	TGTCTCACTGAGAGTCTGTGTGTGTCTG
ATAACATACGATCAGTTAAC	unknown
ATAACATACGCGCGACGAGG	unknown
ATAAGCGGAGAGCCTCCTAT	unknown
ATAAGCGGAGTTACTGCCTT	GTGACAGTGTGAGACAGTCTCACAGTCT
ATAAGTCATGCATGGACTCC	unknown
ATAAGTCATGGTAACGACGC	unknown
ATAATGTAATTATTCATATA	unknown
ATAATGTAATTTCGTAGCAC	AGTGAGTGTCAGAGACTCTGTCTGACAG
ATAATGTAATTTGAAGAAGC	AGTGAGTGTCAGAGACTCTGTCTGACAG
ATACATGGACCATATTAGGA	unknown
ATACCACCTACTCACTGTAG	unknown
ATACCACCTATCTTGGAGAC	GTCTCTCAGTCAGAGACTCACACTCAGT
ATACCACCTATTAACCGCGA	CGACTCTCTGACACTCTGTCAG
ATACCGAGCTCATGCTGACT	unknown
ATACCGAGCTCTGATACTTC	unknown
ATACCGAGCTGATAATGATG	unknown
ATACCGAGCTGTTGCGCCGG	unknown
ATACCGAGCTTGGATTAGAC	unknown
ATACCTCCATAACCTTGCGG	unknown
ATACCTCCATAGTGGACACC	unknown
ATACGGATTATCCTCGTGCG	AGTGAGTGTCAGAGACTCTGTCTGACAG
ATACGTACTGAACGAGGTCC	CGACTGTGTCTCTGACAGTCTCAGAGTG
ATACGTACTGGTCAGTACCA	unknown
ATACTCCTACCGATCACGAT	unknown
ATACTCCTACGGCTTCGTCG	unknown
ATACTCTGTCAGATTGAGAG	unknown
ATACTCTGTCGAGTAGATTG	unknown
ATACTCTGTCGGAGTACGTA	unknown
ATACTCTGTCGTTACGCGTC	unknown
ATAGAGAGCCCAAGCCTTAG	unknown
ATAGAGAGCCGTGTCACGAG	unknown
ATAGCAGGTATCGATGCGCG	unknown
ATAGCTGGATTAGCGCACGT	unknown
ATAGGAGTCTCGCGAGTCGA	CGACTGTGTCTCTGACAGTCTCA
ATATACGCCTCGATATGTGC	GTGACTGTCTGTGACTCTCACAGTGTCA
ATATATGCTCGACTCTCCAA	CCACGGGACCAGTGTCACAGA
ATATATGCTCTCCAGGTACT	TCGAGTCTGTGTCTGGGTCAGTCTCTCT
ATATCAATCGTGCGGTTACG	unknown
ATATCACGAAGACCAGAATA	unknown
ATATCACGAATTCGCATAAT	unknown
ATATCCGAATCGTCCGCTCT	unknown
ATATCCGAATCTTGACTCAA	unknown
ATATCTCGTTAAGTTCGACC	unknown
ATATGATGCTGACCAGTACG	unknown
ATATGATGCTTGTAAGAGCT	unknown
ATATGTCTCATATCATCTCT	unknown
ATATTAACTGCGACGGACGA	unknown
ATATTAACTGGGTGCAACCT	unknown
ATATTAGAGCTAAGCGTGGC	unknown
ATATTCTCACAACGAGGTCC	unknown
ATATTCTCACATAGCTGGAT	unknown
ATATTCTCACGCCAGCACGT	unknown
ATATTCTCACGCGCGCCGAG	unknown
ATATTGATATGTGGACAGGA	unknown
ATCACTGGAAGAACGAATTC	unknown
ATCACTGGAAGCTCAGCTGG	GTGTGAGTGTGACTCTGAGAGACTCTCT
ATCAGAGTCACGAGGAGTCA	unknown
ATCAGTTAACTACGCCGATT	unknown
ATCATTCAGCCATCGGCATG	CTCTGTCAGTCACACACTGTCTCTC
ATCATTCAGCCGCCTCTCGG	unknown
ATCCACTAAGGACTCACCTT	unknown
ATCCGGTGCCATGGCGTGCG	TGTGTGGTGAGACTCACTCTGAGTCTGT
ATCCTAATACGGCTCCAAGC	unknown
ATCCTCATCAAAGTTGGAGG	unknown
ATCCTCATCAAGAGCGGCAA	unknown
ATCCTCATCAGGCTATATAA	unknown
ATCCTCATCATTGACATCTC	unknown
ATCCTGGAGTTTCTCACTCC	unknown
ATCGACATGCCTTGACTCAA	unknown
ATCGACATGCGCACATAGTA	unknown
ATCGAGCGAACCTGCGAACA	AGTGAGTGTCAGAGACTCTGTCTGACAG
ATCGATTCTGCGATCACGAT	unknown
ATCGATTCTGGCCGCAATAG	unknown
ATCGGACAAGCTTCCTACAG	unknown
ATCGGACAAGTCCAATAGAA	unknown
ATCGTATAGGAACGAGTATT	CTCAGTCAGACAGTGTGACTGAGTCA
ATCGTATAGGAACGAGTATT	TCAGTCAGACAGTGTGACTGTGTCACAG
ATCGTCGCAGTGATGACGTA	unknown
ATCTCAAGCCATTACCGCGT	unknown
ATCTCAAGCCGCTCAGCTGG	GTGTGTCTGTGTGTCTGTGTGACTGTGA
ATCTCCAGAAAATCAGTGGA	unknown
ATCTCCAGAAAGAATTCAGT	unknown
ATCTCCAGAACCTTAAGGCT	GACTCTCTGTGAGTGTGTGTCTCTCTCT
ATGACCTCTGACGACGTCCA	unknown
ATGACCTCTGGGCACTGAGC	unknown
ATGACCTCTGTCGATGCGCG	unknown
ATGACGGATAGGCTTCGTCG	unknown
ATGACGGATATATAGAAGCT	unknown
ATGACTATGCAACGAGGTCC	unknown
ATGATCATTAGTAGTTCTAG	unknown
ATGATGTTGCACGACTATTA	unknown
ATGATGTTGCCGATTCCGGC	AGTGTCACAGAGAGTCTCTGACTCAGAG
ATGCACTGGTTGTCAGGCAC	GTGTCAGACAGTGTGTGTGAGTGAGTCA
ATGCGAGCGTAAGTTCGACC	unknown
ATGCGAGCGTCATGCTGACT	unknown
ATGCGAGCGTCCGGTCACTA	unknown
ATGCGAGCGTGTTCGCGCGC	unknown
ATGCGCTAATAAGATCAATT	unknown
ATGCGCTAATCTTCGGCCGG	unknown
ATGCGCTAATGTGTCCATAC	unknown
ATGCTCCAGTGCTTAGTCGG	unknown
ATGGAACAATTGACTTCGTA	unknown
ATGGAAGGCCAGCGATCCAT	unknown
ATGGAAGGCCATACCGAGCT	unknown
ATGGAAGGCCATATTCTCAC	unknown
ATGGAAGGCCCTCAACATGT	unknown
ATGGAAGGCCGCACTTCACG	unknown
ATGGAAGGCCTGGTATTGTC	unknown
ATGGCGTGCGAATCAGTGGA	unknown
ATGGCGTGCGATGTTCTATA	CGAGACTGAGTCTGACTG
ATGGCGTGCGGTTACGCGTC	unknown
ATGGTACCGAACGGCCTGTA	unknown
ATGGTACCGAGATGAGAGGT	unknown
ATGGTTCTAAACGCCTCAGT	unknown
ATGTAAGATTGCGTACAACT	unknown
ATGTACTTAAAGCAGGCAGC	unknown
ATGTACTTAAAGTGGACACC	unknown
ATGTACTTAAATATTCTCAC	unknown
ATGTACTTAACACCGCTAGT	GACTGTGACTCTGTCAGTGAGTCTGACT
ATGTCCGTGCGACTCACCTT	unknown
ATGTCTGCCACGGCAGAGTC	unknown
ATGTCTGCCACTATCACTAG	unknown
ATGTTAGTATTCTCGCGACC	TGAGACACTCTGTGTGTCAGAGTGAGTG
ATGTTCTATACAGCAAGCAG	unknown
ATGTTCTATATTGATCTTAA	unknown
ATGTTGAAGCCTAAGAGTCC	CAGTGAGTGTCAGAGACTCTGTC
ATTAAGATAACACCGCTAGT	unknown
ATTAAGATAACGATTCCGGC	unknown
ATTAAGATAAGGCTATATAA	unknown
ATTAAGATAATTCTCACTCC	unknown
ATTAAGCGCGAATACTCGAT	unknown
ATTAAGCGCGCCGGTGGACA	unknown
ATTAATACAGTCAGATAGAT	unknown
ATTACTAACGACTACGGTCG	unknown
ATTACTAACGCTAGGCCACG	unknown
ATTAGCGGCTTTCCACTACA	unknown
ATTAGTGGTCATGACGGATA	unknown
ATTATAGCACCGGCGATACC	unknown
ATTATAGCACGCGTACAACT	unknown
ATTATCTAGCATGTCTGCCA	unknown
ATTATTGTGCTCACGAATCC	TGTCTCACTGAGAGTCTGTGTGTGTCTG
ATTATTGTGCTGACGTCCTT	unknown
ATTCATCAAGAGACCGATCG	unknown
ATTCATCAAGCTAAGAGTCC	unknown
ATTCATCAAGGCCGCAATAG	unknown
ATTCATCAAGTAACAGCCAA	CGAGACTGTGTCTGTGT
ATTGGTAATCCCGAATCAGT	GACTGTCTGTGACTGTGTCACACACTGA
ATTGGTAATCCCGAATCAGT	CGACTGACTGTGACTGTGTCAC
ATTGGTAATCCCGAATCAGT	CGACTGACTGAGACTGTG
CAACAGACAGCTCTAAGCAT	unknown
CAACATATAAAATGCCAGTT	unknown
CAACATATAAGATTGATGGC	AGTGTGTCAGAGTGTGTCACACTCTCAG
CAACTCGTCGATAGCTGGAT	CGTGACTGTCTGTGACTCTCACAGTGT
CAACTCGTCGATAGCTGGAT	CGTGACTGTCTGTGACTCTCACAGTGT
CAACTCGTCGGGAGCTATGG	unknown
CAACTCGTCGTACGAAGTGC	unknown
CAACTCGTCGTGCGGTTACG	unknown
CAAGAGGTCACTTGTCTAGT	unknown
CAAGATGCCGGAAGACAGAC	unknown
CAAGCAATTCCTCAAGTCGC	unknown
CAAGCTGAAGTACAGTACGC	unknown
CAATAGAGTGACTGGTAAGA	unknown
CAATAGAGTGCTCTAAGCAT	unknown
CAATAGAGTGCTTACCGGTG	unknown
CAATCCGGAGGACTTACTCT	unknown
CAATTGCACACGCCTCTCGG	unknown
CAATTGCACAGTCGGACCTC	unknown
CACAGAAGCCCTCGCAGGTC	unknown
CACAGAAGCCCTTCCGATAA	unknown
CACATGTTACGTCGTCGATC	unknown
CACCGAGCATCTTGTCTAGT	unknown
CACCGAGCATTCCTCGTGCG	unknown
CACCGTGTGTCCACTGGATT	unknown
CACCTAGGAAAAGATTAACC	unknown
CACCTAGGAATACCATGACT	unknown
CACCTCCAATTTCTATCAGC	GAGACTGTGTCTGTGTCAGTCTCTCTCA
CACGCATGCAGTCACGTGCT	unknown
CACGCTCTCTCGATCACGAT	CTGACAGAGTGTGTCACTGAGTCT
CACGGATCGAACATCATTGC	unknown
CACGGATCGAATTAACCGGC	unknown
CACGGATCGAGCGCGCCGAG	unknown
CACGGTCGTAAACCTTGCGG	unknown
CACGTACCAATAACATAGCA	unknown
CACGTGCCGGCGCCTCATCT	unknown
CACGTGCCGGGGAGTACGTA	unknown
CACGTGCCGGTATCATCTCT	unknown
CACTACTTGACGTTCTACGA	unknown
CACTACTTGATACTCAGGAA	unknown
CACTAGATTCAATTCGAAGG	unknown
CACTAGATTCCGTTCGATGG	unknown
CACTAGATTCGGAACGTGCC	unknown
CACTAGATTCTCCTCGTGCG	unknown
CACTATGAGACATATTAGGA	unknown
CACTCAGTCACTTCCTACAG	GACTGTGACTCTGACAGTGAGTCTGACT
CACTCAGTCATAACATAGCA	unknown
CACTCTTAACGTTACGCGTC	unknown
CACTGTGGAAGTCTACCTTC	unknown
CACTGTGGAATAGTTAGACG	unknown
CACTTAGCTAGTCTACCTTC	CAGACAGACTCTCAGTGACA
CAGAATCTTCAGTGTTGCTT	unknown
CAGAATCTTCGAGTAGATTG	unknown
CAGAGCGTGCGCTCAGCTGG	unknown
CAGAGTGCCATACTAATGGC	unknown
CAGATCGGTCGTCAGTACCA	TGTCTCACTGAGAGTCTGTGTGTGTCTG
CAGATTCAACCATCAATTAA	unknown
CAGCCAGACGCAGTGTATGC	unknown
CAGCCAGACGCTAAGAGTCC	unknown
CAGCGAAGTCGGTTGGTAAC	AGTGAGTGTCAGAGACTCTGTCTGACAG
CAGCGAAGTCGTCAGTACCA	CGTGTGTCACAGAGTGTGTCTCTCACTC
CAGCGCCTTGATGACGGATA	GACTGTGTCTCTGACAGTCTCAGAGTGT
CAGCGCCTTGGCGCAGCACC	unknown
CAGCGCCTTGGTAATACGTC	unknown
CAGCGCCTTGTTGTGGCATC	unknown
CAGGAACGAGCGATAAGCAC	unknown
CAGGAACGAGTCGATGCGCG	unknown
CAGGACATACGCTTAGATCT	unknown
CAGGCGTACTCGATTCCGGC	unknown
CAGGCTAAGAACAGTTCATT	unknown
CAGGCTAAGAAGTGGACACC	unknown
CAGGTGTAGAAGCAGGCAGC	unknown
CAGGTGTAGAATCCACTAAG	unknown
CAGGTGTAGACGAGGTTAAC	unknown
CAGGTGTAGAGCGAATCGAC	unknown
CAGGTGTAGATAGGCTCAGG	unknown
CAGGTTAACTCGGCAGAGTC	unknown
CAGGTTAACTGCCAGCACGT	unknown
CAGGTTAACTGCTTAGTCGG	unknown
CAGTAAGGTGGTCGGACCTC	unknown
CAGTCCAGGAATAACATACG	unknown
CAGTCCAGGAATGACGGATA	unknown
CAGTCCAGGACTCACAGCGG	unknown
CAGTGTATGCACAGTCCACC	unknown
CAGTGTATGCCGATATGTGC	unknown
CAGTTCAGCTTGAGGTGGTT	GTCACTGTCTCAGTGACAGTCACTGTCT
CATACACTTGATATTCTCAC	unknown
CATACACTTGCTTGCCGCGC	unknown
CATACATGAGATGTCCGTGC	unknown
CATACCAGTCACTGCACAGG	GAGTCTCAGGCACAGAGTCTGACAGAGT
CATACCAGTCACTGCACAGG	GTGAGTGACACAGTGTGAGAGTCTGTCA
CATACCAGTCAGACCGATCG	unknown
CATACCAGTCGTCAGTACCA	unknown
CATACCAGTCTATGGCATAG	unknown
CATAGAATATCCAGATTCGG	unknown
CATAGAATATGGCACTGAGC	unknown
CATAGCGACGGATGGAGTGC	AGTGTCACAGAGAGTCTCTGACTCAGAG
CATAGCGACGGCTCGGTATG	unknown
CATAGCGACGTGCTGCAGTA	unknown
CATAGTATTACATGCTGACT	unknown
CATCAATTAAGGAGCTATGG	unknown
CATCAATTAATCGACATCGA	unknown
CATCAGTTGGAAGTTCGACC	unknown
CATCAGTTGGCCTTAAGGCT	unknown
CATCATCGATGTTACCACAT	unknown
CATCATCGATTTGAGCCTGA	unknown
CATCATGACCCGACGGACGA	unknown
CATCATGACCTCGCATCTTG	unknown
CATCCTGCACCCGGTGGACA	unknown
CATCCTGCACTATCGCGCCA	unknown
CATCGTCAGTAAGGAATGTA	unknown
CATCGTCAGTATCAGTTAAC	unknown
CATCGTCAGTGTTCGCGCGC	TACCTGACACTGTCTGAGTGACTCAGTC
CATCTATATACGCGACGAGG	unknown
CATCTATATATCCAATAGAA	unknown
CATCTCGTATACATAGGTGG	unknown
CATCTCGTATCTTCGGCCGG	unknown
CATGAAGTGTCTGCAGGATA	unknown
CATGAAGTGTGCTAGTAGAA	unknown
CATGATGCATCACCGCTAGT	GAGAGAGACTGACTGACAGTGTGACACT
CATGCTGACTCCACTGGATT	unknown
CATGCTGACTTTCTATCAGC	unknown
CATGGCTGTACGTTCAATAA	unknown
CATGGCTGTAGTTGCGCCGG	unknown
CATGTCTTGAAATGCCAGTT	unknown
CATGTCTTGATACTCAGGAA	unknown
CATTAACCAATCCAATAGAA	unknown
CATTATCCTTACTTCAACAC	CGTGACTGTCTGTGACTCTCACA
CATTCACACAATATTCTCAC	unknown
CATTCACACATAACATAGCA	unknown
CATTCACACATACGAAGTGC	unknown
CATTCTGGTCAGTGTTGCTT	AGTGAGTGTCAGAGACTCTGTCTGACAG
CATTCTGGTCGGAGCAACAG	unknown
CATTGTTATACAGCGAAGTC	unknown
CATTGTTATAGGAACGTGCC	unknown
CATTGTTATAGGTATCCTTA	unknown
CCAATAGGCAATAACATACG	unknown
CCAATAGGCACGTTCTACGA	CGTGACTGTCTGTGACTCTCACAGTGT
CCAATAGGCACTCACAGCGG	unknown
CCAATAGGCATGAGGTGGTT	unknown
CCAATCGGACCCATAAGGAG	unknown
CCAATTCATCGACTGTTCCT	TGTGACACTCAGTGTGTCTGTCACACAG
CCAATTCATCGTGTCACGAG	unknown
CCAATTCATCGTTGTTCTCT	unknown
CCACAGGTATAGCAGGCAGC	unknown
CCACAGGTATATGTCTGCCA	unknown
CCACAGGTATATTAAGATAA	unknown
CCACGCTGTGAGATTGAGAG	unknown
CCACGCTGTGGACTTACTCT	unknown
CCACTGGATTTTCGTAGCAC	CGAGACTGTGTCTGTGTCAGTCT
CCACTGGATTTTCGTAGCAC	CGAGACTGTGTCTGAGTCAGT
CCACTGGATTTTCGTAGCAC	GAGACTGTGTCTGTGTCAGTCTCTCTCA
CCAGAATTAGCAGGAACGAG	unknown
CCAGAATTAGTCCTCGTGCG	AGTGTCACAGAGAGTCTCTGACTCAGAG
CCAGAGTTGAACCTCTCCTG	unknown
CCAGAGTTGACTTCGATGGT	unknown
CCAGAGTTGAGACATCGGTG	unknown
CCAGATATCTCTCAAGTCGC	unknown
CCAGATTCGGGCGTACAACT	unknown
CCATAAGGAGTCTGTTCATA	unknown
CCATAAGGAGTTGATATTCC	unknown
CCATCGTGACAGAATTCAGT	unknown
CCATCGTGACCGCGACGAGG	unknown
CCATCGTGACGCTAGTAGAA	unknown
CCATGAGAGGATTATTGTGC	unknown
CCATGAGAGGGGTTGGTAAC	unknown
CCATGCTCAGGTGTCCATAC	unknown
CCGAATCAGTGACTCTCCAA	unknown
CCGACACTCTACGACAATAT	unknown
CCGACTTGCACGCCTCTCGG	unknown
CCGACTTGCACTATCACTAG	unknown
CCGACTTGCAGAACGCCGTG	unknown
CCGAGACGTAAGTGGACACC	unknown
CCGAGACGTACATGCTGACT	unknown
CCGAGACGTAGAACGAATTC	unknown
CCGAGCGATTACCGACATTA	unknown
CCGAGCGATTGACTATCACA	unknown
CCGAGGTTGGGACCAGTACG	unknown
CCGAGGTTGGGACTGTTCCT	unknown
CCGAGGTTGGTATGGCATAG	unknown
CCGAGGTTGGTGTGTAGCCG	unknown
CCGAGTGACCGGAGGTTGGT	unknown
CCGAGTGACCTTCGCATAAT	unknown
CCGAGTTCGAACATCATTGC	unknown
CCGAGTTCGAGCGAACACGG	unknown
CCGAGTTCGAGTCTACCTTC	unknown
CCGATACTGAGCAGGTATCC	unknown
CCGATACTGAGCGAACACGG	AGTGTGTGTCAGAGACTCTGTCTGACAG
CCGATTCCAAGTTGGATCCT	unknown
CCGCAGACTGATCAGAGTCA	unknown
CCGCAGGAGCATACCGAGCT	unknown
CCGCAGGAGCCGCACTGGAT	unknown
CCGCATACGTATCAGAGTCA	GTGACAGTGTGAGACAGTCTCACAGTCT
CCGCGGCACTACGACGTCCA	TGACACTCTGTGACTGACTGTCTCACTG
CCGCGGCACTAGTGGTGGTA	CGAGACTGAGTCTGACTGTCAGAGACA
CCGCGGCACTGAACGCCGTG	unknown
CCGGCAATACGAGTAGATTG	unknown
CCGGCAATACGTAGTTCTAG	unknown
CCGGCTACGCCACCGCTAGT	unknown
CCGGCTACGCCGGCGATACC	unknown
CCGGCTACGCTGCAAGATAC	unknown
CCGGCTGATGCTTGCCTACA	unknown
CCGGCTGATGTCAGATAGAT	unknown
CCGGTCACTAAACGAGTATT	unknown
CCGGTCACTACTCACTGTAG	unknown
CCGGTCTCCGAAGTAAGCGT	unknown
CCGGTGGACAACAGTTCATT	unknown
CCGGTGGACATAATCGGTGC	unknown
CCGGTGGACATAGGCTCAGG	CAGAGAGTCTCACTGTCAGTGACTGACT
CCGTAGCTCACGTATCGCCT	unknown
CCGTAGCTCATCTTGGAGAC	unknown
CCGTCCGGTGACCGACATTA	unknown
CCGTCCGGTGCACTCAGTCA	unknown
CCGTCCGGTGCGTACCGCGA	unknown
CCGTGCAACCGGCTCCAAGC	unknown
CCTAACTGAGAAGATTAACC	unknown
CCTAACTGAGAGGCACACCT	unknown
CCTAACTGAGGATATAGCGG	unknown
CCTAGAGCAGGCTTAGTCGG	unknown
CCTAGTGTGGCGTTCTACGA	unknown
CCTAGTGTGGTGATGACGTA	AGTGAGTGTCAGAGTCTCTGTCTGACAG
CCTATCCAAGAGCGATCCAT	unknown
CCTATCCAAGTTCTCACTCC	unknown
CCTCAGGTCGATGTTCTATA	unknown
CCTCAGGTCGTATGAACAGC	unknown
CCTCATGCCACACTCAGTCA	unknown
CCTCCAGATTCAAGAGGTCA	unknown
CCTCGCCTCTTTAACGTAGG	unknown
CCTCGTTGACCGATATGTGC	unknown
CCTCTATCTCATTCCGCTCA	unknown
CCTGAATTCTTCGACATCGA	unknown
CCTGCGAACAAACCTTGCGG	unknown
CCTGCGAACAAATTCGAAGG	unknown
CCTGCGAACAGTTACGCGTC	unknown
CCTGCTTAGTTACCATGACT	unknown
CCTGTTAATGAGAATTCAGT	unknown
CCTGTTAATGAGTCGACCAT	unknown
CCTGTTGCGCCTGATACTTC	unknown
CCTGTTGCGCCTTGTCTAGT	unknown
CCTGTTGCGCGCTCGGTATG	unknown
CCTTACCACACGTATCGCCT	unknown
CCTTGACGGCTAAGCGTGGC	unknown
CCTTGACGGCTTACTGCCTT	unknown
CCTTGGATCCCGATTCCGGC	unknown
CGAAGACAAGGCTTAGATCT	unknown
CGAAGACAAGGTGTCCATAC	unknown
CGAAGGCAGAGACCAGTACG	unknown
CGAATATAGGTCCGACCGTA	unknown
CGAATATAGGTCTCGCGACC	GTGACTGTCTGTGACTCTCACAGTGTCA
CGAATCGCAGAATTCCAACC	unknown
CGAATCGCAGATTACCGCGT	unknown
CGAATCGCAGGGCACTGAGC	unknown
CGACCACTGAAATGCCAGTT	unknown
CGACCACTGACACTCAGTCA	unknown
CGACCTTGGTACGGCCTGTA	unknown
CGACCTTGGTATAGCTGGAT	unknown
CGACCTTGGTGAACGAATTC	unknown
CGACGCTCTCCCGAATCAGT	unknown
CGACGCTCTCGAAGACAGAC	unknown
CGACGCTCTCGTGTCACGAG	unknown
CGACGGACGAAAGCGCCGTA	unknown
CGACGGACGAAATTCGAAGG	unknown
CGACGGACGACATGCTGACT	GTCTGTGACAGTCTGTCTGAGTCTGTCT
CGACGGACGACTTCAATAAT	unknown
CGACGGACGAGTCGTCGATC	TGACAGAGTGTGTCACTGAGTCTCTCTG
CGACGGACGAGTCGTCGATC	TGACAGAGTGTGTCACTGAGTCTCACTG
CGACGTTCCTACATATGCGA	unknown
CGACGTTCCTACTGGTAAGA	unknown
CGACGTTCCTCTAGGCCACG	GAGTGACAGAGAGTGTCTCTGAGTGTGT
CGACGTTCCTCTTCGGCCGG	unknown
CGACGTTCCTGATATGGCAA	TGTCTCACTGAGAGTCTGTGTGTGTCTG
CGACGTTCCTTAGCGCACGT	unknown
CGACTACTCTAGTCGTCCTA	unknown
CGACTACTCTCGTACCGCGA	TGACACTCTGTGACTGACTGTCTCACTG
CGACTTAGTGAGAATTCAGT	unknown
CGAGCAGGTTCAGCGAAGTC	unknown
CGAGCTGGAAACTACGGTCG	unknown
CGAGCTGGAAGCGCGCCGAG	unknown
CGAGGTTAACTTCCACTACA	unknown
CGATACGCCAAGCCTCCTAT	unknown
CGATACGCCACGATTGATAA	unknown
CGATACGCCATAGCTGCTAC	unknown
CGATACTAGCCTGCAGGATA	GAGTGACAGAGAGTGTCTCTGAGTGTGT
CGATAGAATAGCCTCCGGTC	unknown
CGATAGAATAGTTGTCTGAC	unknown
CGATAGAATATTCTCCTGTA	unknown
CGATATGTGCACATCATTGC	unknown
CGATATGTGCGATGAGAGGT	unknown
CGATATGTGCTCTTGGAGAC	unknown
CGATCACGATAACGAGTATT	unknown
CGATCGTCAGGTCACGTGCT	unknown
CGATGAAGTGTCGCATCTTG	unknown
CGATGAAGTGTGGTATTGTC	unknown
CGATGCTGACACGGTACCTC	unknown
CGATGCTGACCATATTAGGA	unknown
CGATTGCGCGACAGTTCATT	unknown
CGCAATCCACCAGGAACGAG	unknown
CGCAATCCACCGTTCGATGG	CAGTGAGTGTCAGAGACTCTGT
CGCAATCCACTTGAAGAAGC	CGAGACTGTGTCTGTGTCAGTCT
CGCACAGGTAAGTGGACACC	unknown
CGCACAGGTATGGATTAGAC	unknown
CGCACTCACCAATTAATCTG	unknown
CGCACTCACCATAGCTGGAT	unknown
CGCACTCACCGTCACGTGCT	unknown
CGCACTCACCTGGATTAGAC	unknown
CGCACTGGATAAGTAAGCGT	GTCTCTGACTCAGTGAGTGTCTGACACA
CGCACTGGATACGAGGCCAT	unknown
CGCACTGGATCGTCCGCTCT	CGACTCACACTGTGTGACAGTCA
CGCCTCATCTATCAGTTAAC	CAGTCTCACTGAGAGTCTGTGT
CGCCTCTCGGAAGTCGATCC	unknown
CGCGAATCAGGGTTGGTAAC	unknown
CGCGAATCAGTCCGAAGATT	unknown
CGCGAATCAGTGTAAGAGCT	unknown
CGCGACGAGGTACAGTACGC	unknown
CGCGACGAGGTTACTGCCTT	unknown
CGCGAGCGATCAAGCCTTAG	unknown
CGCGAGGACCAGTTGTCGAA	unknown
CGCGAGGACCGTTACCACAT	unknown
CGCGATACCTAGACTTACGT	TGTGACACTCAGTGTGTCTGTCACACAG
CGCGCATACGACCAAGCCAG	unknown
CGCGCATACGTCGATGCGCG	unknown
CGCGTGTAATGCGGTGCAGA	unknown
CGCGTGTAATGCTGTGAGAC	AGTGAGTGTCAGAGACTCTGTCTGACAG
CGCGTGTAATTCATCGGATT	unknown
CGCTCGCCTCAAGTCACGGC	unknown
CGCTGAATTCCTCTGTCTCC	unknown
CGCTGCCGTGTATCGGAATA	unknown
CGCTGCTTAGATCAGAGTCA	unknown
CGGACCACCTGTGAACGAGA	unknown
CGGACCTTGGAACGAGGTCC	unknown
CGGACCTTGGACGCCTCAGT	unknown
CGGACCTTGGACTGCACAGG	unknown
CGGACCTTGGGCTCTCGGTT	unknown
CGGACGGATTTACGGACTCT	unknown
CGGCCTCATCAAGTTGGAGG	unknown
CGGCCTCATCCTCACTGTAG	unknown
CGGCCTCATCTACCATGACT	unknown
CGGCGAGCGAACCTCTCCTG	unknown
CGGCGAGCGACTGTGAGCAG	unknown
CGGCGAGCGATTCAGTGCGG	TGTCTCACTGAGAGTCTGTGTGTGTCTG
CGGCGATACCTCGACATCGA	unknown
CGGCGTGTAAGTCTCACAGT	CGTGACTGTCTGTGACTCTCACAGTGT
CGGTAAGATACAATCTCATG	unknown
CGGTAGACACACGACGTCCA	unknown
CGGTAGACACTCCTCCTGGC	unknown
CGGTCCAAGGAATAATGCAC	unknown
CGGTCCAAGGATCTCGCTGC	unknown
CGGTCCAAGGCTCAAGTCGC	unknown
CGGTCCGCTCATATTCTCAC	unknown
CGGTTGGTGGGCCAGCTTCG	unknown
CGGTTGGTGGTCCTCCTGGC	unknown
CGTACCGCGAACATCATTGC	unknown
CGTACCGCGAGATGAGAGGT	unknown
CGTACCGCGATATTACTCTC	CTGTCACTGTGTGTGTGTGACACTCT
CGTACCGCGATCTTGGAGAC	unknown
CGTACTTATTCCATAAGGAG	unknown
CGTACTTATTCCGAGCGATT	unknown
CGTACTTATTTTCAGTGCGG	unknown
CGTAGACACTTGACGTCCTT	CACTGTCAGACTCAGACACT
CGTAGACACTTGACGTCCTT	GAGAGTGTCAGTCTGACACACACTCTGA
CGTAGCGGCAATCCACTAAG	unknown
CGTAGCGGCATATGGCATAG	unknown
CGTATCGCCTATTACCGCGT	unknown
CGTATCGCCTGACTATCACA	unknown
CGTATGAATTCGAGGAGTCA	unknown
CGTATGAATTTTCGTAGCAC	GTCACTGTCTCAGTGACAGTCACTGTCT
CGTATGAATTTTCGTAGCAC	TGGGGGCGTCACTGTCTCAGTGACAGTC
CGTATGAATTTTCGTAGCAC	GTCACTGTCTCAGTGACAGTCACTGTCT
CGTCAACATGATACTGAGGA	unknown
CGTCCGCTCTCGTACCGCGA	unknown
CGTCCGCTCTGTAGACGGAG	CGACTGTGACTCTGACAGTGA
CGTCCGCTCTTGTGTGTAAC	unknown
CGTCGGTTAAACATGCCTGT	unknown
CGTCGGTTAAACGACAATAT	unknown
CGTCGGTTAATGCTCAGAAG	unknown
CGTCGTTCAGGACTGTTCCT	unknown
CGTCGTTCAGGCTAGTAGAA	unknown
CGTCTAAGCAAGAATTCAGT	unknown
CGTCTCAGACCCGGTCACTA	unknown
CGTCTGCTGAACTGGTAAGA	unknown
CGTCTGCTGACGGACTGAGG	unknown
CGTCTGCTGATTGAGCCTGA	unknown
CGTGGCAACAGTACATAGGC	unknown
CGTTCAATAAACGGCGAGGC	unknown
CGTTCAATAACCTGCTTAGT	GAGTCTCAGACACAGAGTCTGACAGAGT
CGTTCGATGGAGACCGTCGT	unknown
CGTTCGATGGCTCGCAGGTC	GTGACTGACTGTGTGTCTCTCTGTCTGA
CGTTCTACGAACTGGTAAGA	GACTGTGACTCTGACAGTGAGTCTGTCT
CGTTCTACGAGATGAGAGGT	unknown
CGTTCTACGATATCATCTCT	unknown
CGTTGGTGGTATGTTCTATA	unknown
CGTTGGTGGTCTTCAATAAT	unknown
CGTTGTAGCACATGGACTCC	unknown
CGTTGTAGCACTAAGATATT	unknown
CTAAGAGTCCACATAGGTGG	unknown
CTAAGAGTCCCTTCTTCGTA	unknown
CTAAGATATTCGCCTCATCT	unknown
CTAAGATATTGACTCACCTT	unknown
CTAAGATATTGCTTAGTCGG	unknown
CTAAGATATTTAGTCGGAAT	unknown
CTACAATACGCTTCCGATAA	unknown
CTACAATACGGTCACGTGCT	CGTGAGTGACACAGTGTGAGCGTC
CTACAATACGGTCACGTGCT	GACAGAGTCACTGAGTGAGTGACAGAGT
CTACCGCGATACTACGGTCG	unknown
CTACCGCGATCTTGCCTACA	AGTGAGTGTCAGAGACTCTGTCTGACAG
CTACCGGACCAGCACAGTTG	unknown
CTACCGGACCCCATCGTGAC	unknown
CTACCGGACCTAGCGCACGT	unknown
CTACCGTCGAAGACCGTCGT	unknown
CTACGTAGGTAAGTCGATCC	unknown
CTACGTAGGTAATTAATCTG	unknown
CTACGTAGGTCTAAGATATT	unknown
CTACGTAGGTGAACGCCGTG	unknown
CTACTCATCCGGAGGTTGGT	unknown
CTACTCATCCTCCAGGTACT	unknown
CTACTGATGGGACTATCACA	unknown
CTACTGATGGTAGTTGTCAC	GGCAGACAGTGACTGTCTGAGAGTGTCT
CTAGACACTTAATTAATCTG	unknown
CTAGACACTTACTGCACAGG	unknown
CTAGACACTTCCTGCTTAGT	TCTGTCAGTGTCACAGTCACAGTGAGTG
CTAGCGGCATAACAGCATAG	CGAGTCAGTCTGTCTGTCTGACTCTCAC
CTAGTGTAACAAGATTAACC	unknown
CTATCAAGCAAAGTTGGAGG	unknown
CTATCAAGCAAGCAGGCAGC	TCGATTGTGTCTCTGACAGTCTCAGAGT
CTATCAAGCAAGCAGGCAGC	CGACTGTGTCTCGGACAG
CTATCAAGCAAGGCACACCT	TCAGTCAGACAGTGTGACTGTGTCACAG
CTATCAAGCAAGGCACACCT	CTCAGTCAGACAGTGTG
CTATCAAGCACTTCGATGGT	GTGACAGTGTGAGACAGTCTCACAGTCT
CTATCACTAGAGACCGTCGT	GAGTGAGACTGTCAGACTGTCTGTCAGA
CTATCACTAGGATTCAGAGA	unknown
CTATCACTAGTTACCAAGGT	unknown
CTATCGCCTTCAAGCTGAAG	unknown
CTATCGCCTTCGCTGAATTC	unknown
CTATCGCCTTGAGTAGATTG	unknown
CTATCGCCTTGCCGGTTGTA	GAGAGAGACTGACTGACAGTGTGACACT
CTATCGCCTTGCGAATCGAC	CGACTGTGACTCTGACAGTGAG
CTATCTCCGGACGACGTCCA	GACTGTCTGTGACTGTGTCACACACTGA
CTATCTCCGGGGACACTCTT	unknown
CTATCTCCGGGGCTCCAAGC	AGTGACACTCAGTGTGTCTGTCACACAG
CTATCTCCGGTAACAGCCAA	TGACACTGTCTGAGTGACTCAGTCAGAG
CTATGAACGAATACTCCTAC	unknown
CTATGTATAAACCAATCTAA	unknown
CTATGTATAAGAGGTGCCGC	unknown
CTATGTCGCGCATCGGCATG	unknown
CTATGTCGCGCGATTCCGGC	unknown
CTATGTCGCGTCTAATGACG	unknown
CTCAACATGTTGCAAGATAC	AGTGAGTGTCAGAGACTCTGTCTGACAG
CTCAAGGACAACCTCTCCTG	unknown
CTCAAGGACAATAGCTGGAT	unknown
CTCAAGGACATCCGACCGTA	unknown
CTCAAGGACATCTTGGAGAC	unknown
CTCAAGTCGCAAGTAAGCGT	CGACTGTGTGTCAGAGACA
CTCAAGTCGCCTCGCAGGTC	unknown
CTCAAGTCGCTAATCGGTGC	unknown
CTCACTGTAGTTCGCATAAT	unknown
CTCAGAGGCGGATAATGATG	unknown
CTCCATGGAAGCCTCCGGTC	unknown
CTCCATGGAAGCGCGCCGAG	GAGACTGTGTCTGTGTCAGTCTCTCTCA
CTCCGGATTCCGTACCGCGA	unknown
CTCCGGATTCGCTTCTGTAC	unknown
CTCCGGATTCGGAGTACGTA	unknown
CTCCGGATTCTCAGATAGAT	unknown
CTCCTCCTAACCTGCTTAGT	unknown
CTCCTCTGTACTCTGTCTCC	unknown
CTCCTGAGGCCCTGCTTAGT	unknown
CTCCTGAGGCCGTCCGCTCT	unknown
CTCCTGAGGCCTCACCTAAG	CGAGTGAGACTGTCAGACTGTCTGTCAG
CTCCTGAGGCTCTGTTCATA	unknown
CTCGAACCTTGCTTAGATCT	unknown
CTCGAACCTTGTCACGTGCT	unknown
CTCGAGAGCAATGTTCTATA	GAGTGAGACTGTCAGACTGTCTGTCAGA
CTCGAGAGCATCCTCGTGCG	unknown
CTCGAGCTAGGTGTCACGAG	unknown
CTCGATTGGTGCGTACAACT	TCTGTCAGTCACACACTGTCTCTCTCTG
CTCGATTGGTTAACAGCCAA	unknown
CTCGATTGGTTGTATTCAGA	TGACAGACAGACTGAGAGTCTGAGTCTG
CTCGCAGGTCATACTCCTAC	unknown
CTCGGCGTATATACCGAGCT	unknown
CTCGGCGTATCGCGAGTCGA	TGACACTCTGTGACTGACTGTCTCACTG
CTCGGCGTATCGCGAGTCGA	GTCCTGACACTCTGTGACTGACTGT
CTCGGCGTATCTTCTTCGTA	unknown
CTCGGCGTATGTCGCGATTC	unknown
CTCGGCGTATTTGACATCTC	unknown
CTCGTGCATGACGGCCTGTA	unknown
CTCGTGCATGCCAGATTCGG	CGTGTGTCTGAGAGAGTCTCTG
CTCGTGCATGCCAGATTCGG	GTGTGTCTGAGAGAGTCTCTGACAGAGA
CTCTAAGCATACCTCTCCTG	unknown
CTCTAAGCATGTCCAGACGA	unknown
CTCTAAGCATTGTGTGTAAC	unknown
CTCTATGCTACATGCTGACT	unknown
CTCTATGTGTAATCAGTGGA	unknown
CTCTATGTGTATCGGACAAG	unknown
CTCTCACGACCCGTGCAACC	unknown
CTCTCACGACGACTTACTCT	unknown
CTCTCCATAGGGAGGTCCAA	unknown
CTCTCCATAGGTAACGACGC	unknown
CTCTGTCTCCCGATTGATAA	unknown
CTCTGTCTCCCTTCAATAAT	unknown
CTCTTCCGGTCCGTGCAACC	GTGTGTCTGAGAGAGTCTCCGACAGAGA
CTCTTCCGGTGATAATGATG	GAGTGAGACTGTCAGACTGTCTGTCAGA
CTGAACCACATCGATGCGCG	unknown
CTGACCTGGTGATAATGATG	unknown
CTGACCTGGTGCGAACACGG	CTCTGTCAGTCACACACTGTCTCT
CTGAGACGGCAGTGGTGGTA	unknown
CTGAGACGGCATACTGAGGA	unknown
CTGAGACGGCTGATGACGTA	unknown
CTGAGCATGGTCAGATAGAT	unknown
CTGAGCATGGTCCGAAGATT	unknown
CTGATACTTCACATCATTGC	GTGTGAGTGTGACTCTGAGAGACTCTCT
CTGCGAGGTGAAGTAAGCGT	unknown
CTGCGAGGTGGCCGCAATAG	unknown
CTGCGAGGTGGCTAGTAGAA	unknown
CTGCTAGTGGTCCGAAGATT	unknown
CTGGCTACTAATGACGGATA	unknown
CTGGCTATGTGTTGTTCTCT	unknown
CTGTACCTTGGTCGTCGATC	unknown
CTGTGAGCAGCTAAGATATT	unknown
CTGTGAGCAGTATCGGAATA	unknown
CTGTGCTAGGCTCAACATGT	unknown
CTTAAGCTCAGATGGAGTGC	unknown
CTTACCGGTGAGGCACACCT	unknown
CTTACCGGTGCTCGCAGGTC	unknown
CTTAGCAACCAGTAGTTACG	unknown
CTTAGCAACCTGGAGCTCAG	unknown
CTTCACGTTAGACTCACCTT	unknown
CTTCACGTTATCGACATCGA	CGTGACAGTGTGAGACAGTCTCACAGT
CTTCATAACGAGACTTACGT	unknown
CTTCATTATAGGACACTCTT	GTGACTGTCTGTGACTCTCACAGTGTCA
CTTCCAATGGTGTGTGTAAC	unknown
CTTCCATCCTACTGGTAAGA	unknown
CTTCCATCCTCTATCGCCTT	unknown
CTTCCATCCTGTCTCACAGT	unknown
CTTCCTACAGTCCGACCGTA	unknown
CTTCGACCAAAAGTAAGCGT	unknown
CTTCGACCAACGTCCGCTCT	unknown
CTTCGATGGTCGACGGACGA	unknown
CTTCGATGGTGAGGTGCCGC	TGACAGAGTGTGTCACTGAGTCTCTCTG
CTTCGGCCGGATGTCCGTGC	unknown
CTTCGGCCGGCTTCTTCGTA	unknown
CTTCTACGATGTCTCACAGT	unknown
CTTCTATCGAAAGTCACGGC	unknown
CTTCTATCGACATGGACTCC	unknown
CTTCTATCGACGTTCGATGG	unknown
CTTCTATCGAGTTACGCGTC	unknown
CTTCTATCGATCACGAATCC	CACTCTCACACTCTCTCTGTCA
CTTCTATCGATCTAATGACG	unknown
CTTCTTCGTACGCCTCTCGG	unknown
CTTCTTCGTACGCTGAATTC	unknown
CTTCTTCGTAGTGGACAGGA	unknown
CTTGAAGAGAGTATTGGCTA	unknown
CTTGACTCAAACCTCTCCTG	unknown
CTTGACTCAAAGTTGTCGAA	unknown
CTTGACTCAAATAGAGAGCC	unknown
CTTGACTCAACTCACCTAAG	GAGACTGTGTCTGTGTCAGTCTCTCTCA
CTTGACTCAAGGAGGTCCAA	unknown
CTTGAGGAAGTTCTCACTCC	unknown
CTTGCCAATGAGTTCCTGTC	unknown
CTTGCCGCGCTAGGCTCAGG	unknown
CTTGCCGCGCTATCGGAATA	unknown
CTTGGCGGCCACCAATCTAA	unknown
CTTGGCGGCCCCATAAGGAG	unknown
CTTGGCGGCCTCCGAAGATT	GACTGTGTCTCTGACAGTCTCAGAGTGT
CTTGGCGGCCTCTTCATCTC	unknown
CTTGTAGCATGTTACGCGTC	unknown
CTTGTCTAGTCGAGGAGTCA	unknown
CTTGTCTAGTGTAATTGACA	unknown
CTTGTTGCTAGTAATACGTC	unknown
CTTGTTGTGTAAGGATTGAT	AGTGTGTCAGAGTGTGTCACACTCTCAG
CTTGTTGTGTGGAGCTATGG	unknown
CTTGTTGTGTGTCTACCTTC	TCAGTCAGACAGTGTGACTGTGTCACAG
GAACCGCCTCGATGGAGTGC	CTGTCTCACTGAGAGTCTGTGT
GAACCGCCTCGATGGAGTGC	TGTCTCACTGAGAGTCGGTGTGTGTCTG
GAACCGCCTCGCAGGTATCC	unknown
GAACGCCGTGACATAGGTGG	unknown
GAACGCCGTGCACCGCTAGT	unknown
GAACGCCGTGGTCACGTGCT	unknown
GAACGTGAAGCTAGGCCACG	TCACTCTTCTCACTGTCAGAGACAGTGT
GAAGAATGTGCTTGCCTACA	unknown
GAAGAGCCTTACATAGGTGG	unknown
GAATCCACTTTTCGTAGCAC	unknown
GAATCCATGAATAGAGAGCC	unknown
GAATCCATGAATCAGTTAAC	unknown
GAATCCATGAGTAATTGACA	unknown
GAATGTAGGCTCTAATGACG	GGCGAGACTGTGTCTGGGTCAGT
GAATGTAGGCTCTAATGACG	CGAGACTGTGTCTGTGTCAGTCTCC
GAATTAGAAGCGTACCGCGA	unknown
GAATTAGAAGCTTCCGATAA	unknown
GAATTCTCGGTGTGTGTAAC	unknown
GACAAGCCTACACATGTTAC	unknown
GACAAGCCTACTCTCCATAG	unknown
GACAATTGAGACGACGTCCA	unknown
GACAATTGAGAGATTGAGAG	unknown
GACAGTTAGGCTTCAATAAT	unknown
GACAGTTAGGGCGACAGTGT	unknown
GACAGTTAGGGTATTGGCTA	unknown
GACAGTTAGGGTCGCGATTC	unknown
GACATCGGTGCTTGTAGCAT	unknown
GACATTCAAGAATACTCGAT	unknown
GACATTCAAGATGGCGTGCG	CGTGTCTCACTGTGAGTGTGTGAGACT
GACCAGAATAACGACAATAT	unknown
GACCAGAATAAGAATTCAGT	unknown
GACCAGTACGCGATAAGCAC	unknown
GACCATGTGCCAAGAGGTCA	unknown
GACCATGTGCCGATTGATAA	TCTGTCAGTCACACACTGTCTCTCTCTG
GACCATGTGCCGATTGATAA	CTCTGTCAGTCACACACTGTCTCTCT
GACCGCTGACACTGGTAAGA	TGTGACACTCAGTGTGTCTGTCACACAG
GACCGTCTCTCGTATTGCTC	unknown
GACCGTCTCTCTTCCATCCT	unknown
GACCGTCTCTGACTTACTCT	unknown
GACCGTCTCTTAACATAGCA	unknown
GACCGTCTCTTAGAAGACTC	unknown
GACCTAATGGAAGATCAATT	unknown
GACCTGCGCGATACTGAGGA	unknown
GACCTGCGCGGGAACGTGCC	CGACTGTGTCTCAGACAGTCTCAGAGTG
GACGAAGACTTGCTGCAGTA	unknown
GACGCCTAGTACGAGGCCAT	unknown
GACGCCTAGTGCCTCTGGCT	unknown
GACGCCTAGTGTAATTGACA	unknown
GACGCCTAGTTCAGATAGAT	unknown
GACGCGGTTGGACTATCACA	unknown
GACGCGGTTGTCCGTGAAGC	unknown
GACGGACAGCAGTAGTTACG	unknown
GACGGACAGCATACTGAGGA	unknown
GACGGACAGCGACCAGAATA	unknown
GACGGACAGCGCTCGGTATG	unknown
GACGGACAGCGTGTCACGAG	unknown
GACGTATAACAGCCTCCTAT	unknown
GACGTATAACGTGTGAAGTT	unknown
GACGTCAATGAAGTTGGAGG	TGACAGAGTGTGTCACTGAGTCTCACTG
GACGTCAATGTTCGTAGCAC	unknown
GACGTCTACAAACTTGCACC	unknown
GACGTCTACACTTCTTCGTA	unknown
GACGTGGCCGGAGACAACGG	unknown
GACTAAGGTCCGGACTGAGG	unknown
GACTAAGGTCGCTCTCGGTT	TGTCTCACTGAGAGTCTGTGTGTGTCTG
GACTAAGGTCGGCCTGCACA	unknown
GACTATCACAATGACGGATA	unknown
GACTCACCTTACGACGTCCA	unknown
GACTCACCTTTCCGTGAAGC	unknown
GACTCGAGCAGCGCGCCGAG	TGTCTCACTGAGAGTCTGTGTGTGTCTG
GACTCGAGCATCCTCGTGCG	unknown
GACTCGAGCATGGAGCTCAG	unknown
GACTCGCTAGAGTAGTAATA	unknown
GACTCGCTAGCATATTAGGA	unknown
GACTCGCTAGCCGGTGGACA	unknown
GACTCGTGTGAACGAGGTCC	unknown
GACTCTCCAAGCACTTCACG	unknown
GACTCTCCAATCCTGATCAA	unknown
GACTGCTCTCACTACGGTCG	unknown
GACTGCTCTCAGACCGTCGT	CGACTGTGTCTCTGACAGTCT
GACTGCTCTCGTGGACAGGA	unknown
GACTGGACGAATAGCTGGAT	unknown
GACTGGACGAGAACGCCGTG	unknown
GACTGGACGAGATAATGATG	unknown
GACTGGACGATCCGTGAAGC	unknown
GACTGTATGGAAGTTGGAGG	unknown
GACTGTATGGATCGGACAAG	unknown
GACTTACTCTATCCACTAAG	unknown
GACTTACTCTCCGGTGGACA	unknown
GACTTACTCTGTAATTGACA	unknown
GACTTGAGGTCAACTCGTCG	AGTGTCACAGAGAGTCTCTGACTCAGAG
GACTTGAGGTCAACTCGTCG	AGTGTCACAGAGAGGCTCTGACTCAGAG
GACTTGAGGTCTTCGATGGT	TGTCTCAGTCAGAGTCAGAGACAGTCAG
GAGAACGCTAAACTTGCACC	unknown
GAGAACGCTAAAGTTCGACC	CCGTGTGTCTGAGAGAGTCCCTGCCAGA
GAGAACGTGTCCTTACCACA	unknown
GAGAACGTGTGTCTCACAGT	unknown
GAGAAGAACAGCACTTCACG	GACTGTGACTCTGACAGTGAGTCTGTCT
GAGAAGAACAGCACTTCACG	GACTGTGACTCTGACAGTGAGTCTGTCT
GAGAAGAACATCCGACCGTA	unknown
GAGAATTAGTACGACTATTA	unknown
GAGAATTAGTCTTCAATAAT	unknown
GAGACAACGGGCTGTGAGAC	unknown
GAGACAGATCCGAGGTTAAC	unknown
GAGACATTCTCAGGAACGAG	unknown
GAGACATTCTGATGAGAGGT	unknown
GAGACTATAGAATTCCAACC	unknown
GAGACTATAGAGTGGTGGTA	GTGTGTCTGAGAGAGTCTCTGACAGAGA
GAGACTATAGTTCCACTACA	TGACACTCTGTGACTGACTGTCTCACTG
GAGACTCGCAACGGTACCTC	unknown
GAGAGAAGCGTCTTGGAGAC	unknown
GAGAGCCTCCGCTGTGAGAC	unknown
GAGAGCCTCCTCCTGGTCGG	unknown
GAGAGCCTCCTTCTCACTCC	unknown
GAGAGTTGATAACGAGGTCC	GAGACTGTGTCTGTGTCAGTCTCGCTCA
GAGAGTTGATTACTCAGGAA	unknown
GAGATATTGAATTCCGCTCA	unknown
GAGATATTGATATCATCTCT	unknown
GAGATATTGATTGAGCCTGA	unknown
GAGATGCGTGCCGGTGGACA	unknown
GAGATGTTAGAGACCGATCG	unknown
GAGATGTTAGCTAGTGTAAC	unknown
GAGCATAGAAAAGTTCGACC	unknown
GAGCATAGAACGGACCACCT	AGTGTCACAGAGAGTCTCTGACTCAGAG
GAGCATAGAACGGACCACCT	AGTGTCACAGAGAGTCTCTGACTCAGAG
GAGCATAGAAGTCGTCGATC	unknown
GAGCATAGAAGTGTCACGAG	unknown
GAGCCACAGGATGGAAGGCC	unknown
GAGCCACAGGGTGTGAAGTT	AGTGTCACAGAGAGTCTCTGACTCAGAG
GAGGCAAGTCCCATCGTGAC	unknown
GAGGCAAGTCGGACACTCTT	unknown
GAGGCAAGTCTGCTCAGAAG	unknown
GAGGCCTGAGAAGTTCGACC	unknown
GAGGCCTGAGAGTGGTGGTA	unknown
GAGGTGCCGCAGTCTATCGT	unknown
GAGGTGCCGCTCGACATCGA	unknown
GAGTAGTTCAAATTAATCTG	unknown
GAGTAGTTCACCATAAGGAG	unknown
GAGTATATGTAACTTGCACC	unknown
GAGTATATGTAGAGAGTCGC	unknown
GAGTATATGTCGATTCCGGC	unknown
GAGTATTCCGAGAATTCAGT	unknown
GAGTATTCCGCATGGACTCC	unknown
GAGTCCGTAGAATACTCGAT	unknown
GAGTCCGTAGCAGTGTATGC	unknown
GAGTCCGTAGGGTATCCTTA	CGTGAGTGTCAGTGTCAGTCACA
GATAACATCAAGTTCCTGTC	unknown
GATAACATCAATTATTGTGC	unknown
GATAACATCACACCGAGCAT	unknown
GATAAGGAGTATCTCGCTGC	unknown
GATAATACGCACGACTATTA	unknown
GATAATACGCCAGCGAAGTC	unknown
GATAATACGCCAGTCCAGGA	unknown
GATAATACGCCGAGGAGTCA	GTGACAGTGTGAGACAGTCTCACAGTCT
GATAATACGCGCAACTATTG	unknown
GATAGGCACCGGAGGTTGGT	unknown
GATAGGCACCTAACATAGCA	unknown
GATATAGCGGGCCAGCTTCG	unknown
GATATAGCGGGCTTCTGTAC	unknown
GATATTGTAGATAGAGAGCC	unknown
GATATTGTAGCCTGCGAACA	unknown
GATATTGTAGGCGTTAGATG	GACAGACTGAGACTCTGTGTGACACTCT
GATCGTCGACCGTTCTACGA	unknown
GATCGTCGACGATTGATGGC	GTGACACTGTCTCAGAGACTGACAGAGA
GATCGTGACTGACTGTTCCT	unknown
GATCGTGACTTACGGACTCT	CAGTGAGTGTCAGAGACTCTGTCT
GATCGTGACTTACGGACTCT	AGTGAGTGTCAGAGACTCTGTCTGACAG
GATGAACTCTCCAGATTCGG	GTCACTGTCAGACACTGAGTCAGTGTGT
GATGAACTCTCTTGTAGCAT	unknown
GATGAACTCTGATGAGAGGT	unknown
GATGAACTCTGTCAGTACCA	unknown
GATGATTGCAGACTCTCCAA	unknown
GATGCGCATGCATGCTGACT	CGACCAGTGAGTGTCAGAGACTCTGTCT
GATGCGCATGCTTGCCTACA	unknown
GATGGAGTGCAACGAGGTCC	unknown
GATGTAGGTCACGACTATTA	unknown
GATGTAGGTCGACTTACTCT	unknown
GATTACGCGCACCAATCTAA	unknown
GATTACGCGCACGTTGAATA	unknown
GATTACGCGCCTTGACTCAA	TGTGACACTCAGTGTGTCTGTCACACAG
GATTACGCGCTTCTCCTGTA	unknown
GATTACTACAACCAAGCCAG	unknown
GATTCCTCAAATTATCTAGC	GACTCTCTGTGAGTGTGTGACTCTCTCT
GATTCCTCAATCCTGATCAA	unknown
GATTCGGAAGATCAGTTAAC	unknown
GATTCGGAAGTTCTCACTCC	unknown
GATTGATGGCGACCAGAATA	unknown
GATTGATGGCGCTAGTAGAA	unknown
GCAACAGAACACAGTTCATT	unknown
GCAACAGAACGTTGCGCCGG	unknown
GCAACAGAACTTAACGTAGG	unknown
GCAACCGACAGCACTTCACG	unknown
GCAACCGACATTAACCGCGA	unknown
GCAACCTCGCATGCGAGCGT	unknown
GCAACCTCGCGACTATCACA	unknown
GCAACTATTGAATTCCAACC	unknown
GCAACTATTGCGCTGAATTC	unknown
GCAACTATTGCGTTCTACGA	unknown
GCAAGACCGTCATTCCGGCT	unknown
GCAAGACCGTCTTCTTCGTA	unknown
GCAAGTCTATACCAATCTAA	GAATCTCACTCTGTGTGGGAGACTGTCT
GCAAGTCTATTGGAGCTCAG	TGTCACTGTGTGTGTGTGACACTCTGAG
GCAATGATCAAACAGCATAG	unknown
GCAATGATCAGACTTACTCT	unknown
GCAATGATCAGGCACTGAGC	GAGTCACCTCTGAGTGTCTCAGAGACTG
GCAATGCGAGGAGGTGCCGC	GTGTGTCTGAGAGAGGCTCTGACAGAGA
GCAATGCGAGGAGGTGCCGC	GTGTGTCTGAGAGAGTCTCTGACAGAGA
GCAATGCGAGTCATCGGATT	unknown
GCAATGCGAGTCCTGGTCGG	unknown
GCACATTGCGTTGACATCTC	unknown
GCACCGCATACGTTCAATAA	AGTGTCACAGAGAGTCTCTGACTCAGAG
GCACCGCATACTAGGCCACG	AGAGACTGTGTCTGTGTCAGACTCTCTC
GCAGCAAGACAGTCTATCGT	unknown
GCAGCAAGACCTTACCGGTG	unknown
GCAGCCTGTGTTGACATCTC	unknown
GCAGGTATCCTCGATGCGCG	unknown
GCAGTCAGGTCGTACCGCGA	unknown
GCATATACAACCTGCGAACA	unknown
GCATATACAACGTCCGCTCT	unknown
GCATCCGTTGGACGAAGACT	unknown
GCATCCGTTGGTCACGTGCT	unknown
GCATCCGTTGTATTCATATA	unknown
GCATTGTACAAGCCTCCTAT	unknown
GCATTGTACACAGTGTATGC	unknown
GCATTGTACACCGTGCAACC	GAGTCAGTGTGTGAGAGAGTGTCTCAGT
GCATTGTACACCGTGCAACC	GAGTCAGTGTGTGAGAGAGTGTCTCAGT
GCCAAGCATCTTGATCTTAA	TCACTGACAGAGAGTGTGACTCACAGAG
GCCAAGCATCTTGATCTTAA	CTCACTGACAGAGAGTGTGACTCACAG
GCCACCAGCTCCACTGGATT	unknown
GCCACTAGTCATCCACTAAG	unknown
GCCACTAGTCGCCAGCTTCG	unknown
GCCAGCACGTGCTTCTGTAC	unknown
GCCAGCATTATATTACTCTC	unknown
GCCAGCTTCGGGAGGTCCAA	unknown
GCCAGGTTGCAGGCACACCT	unknown
GCCAGGTTGCGCACTTCACG	unknown
GCCAGGTTGCTCGCATCTTG	unknown
GCCAGTGACGTAGGCTCAGG	unknown
GCCATCAGGACGTATTGCTC	unknown
GCCATGTGTCACATAGGTGG	unknown
GCCATGTGTCCGATATGTGC	unknown
GCCATGTGTCCTATCACTAG	unknown
GCCATGTGTCTCTTCATCTC	unknown
GCCGAATAGTCTCGCAGGTC	unknown
GCCGACGCATCTTGTAGCAT	unknown
GCCGCAATAGGACTATCACA	unknown
GCCGCAATAGGTCAGTACCA	unknown
GCCGCAATAGTTCAGTGCGG	unknown
GCCGCACGCAAGATTGCTCA	unknown
GCCGCGACTTAACGAGGTCC	AGACTCTCTGAGAGAGTCTGAGACTGAG
GCCGCGACTTGAGACAACGG	unknown
GCCGCGATGATTCACTGGCG	unknown
GCCGCTGATCGGAGTACGTA	unknown
GCCGGTAGCGGACATCGGTG	GTGAGTCTCAGACAGACTGTCTGTCTGT
GCCGGTTGTACAGTCCAGGA	CAGTGAGTGTCAGAGACTCT
GCCGTACGGTGCGCAGCACC	unknown
GCCGTCGAGAACGACAATAT	CTGTGAGACTGTGTGAGAGTGAGA
GCCGTCGAGAGAGGTGCCGC	unknown
GCCTCCGGTCTCCGTGAAGC	unknown
GCCTCTCAACGTAATACGTC	unknown
GCCTCTCAACTACGTTATGG	unknown
GCCTCTCAACTTAACGTAGG	unknown
GCCTCTGGCTACAGTTCATT	GACTGTGTCTCTGACAGTCTCAGAGTGT
GCCTCTGGCTACAGTTCATT	CGTGAGTCTGACTCTGTCTCT
GCCTCTGGCTCGGACTGAGG	unknown
GCCTGGAAGCTGGACGTGAC	GACTGTGACTCTGACAGTGAGTCTGTCT
GCCTGGAAGCTGGACGTGAC	GACTGTGACTCTGACAGTGAGTCTGTCT
GCCTGTGCGTCACCGAGCAT	unknown
GCCTGTGCGTGGAGCAACAG	unknown
GCCTGTGCGTTACGGACTCT	TGACAGAGTGTGTCACTGAGTCTCTCTG
GCCTGTGTTAGCCGCAATAG	unknown
GCGAACACGGATCCACTAAG	unknown
GCGAACGATCTAGCTGCTAC	unknown
GCGAATGACTAATCTACAAG	unknown
GCGAATGACTCGCCTCTCGG	unknown
GCGAATGACTTCATCGGATT	unknown
GCGACAGTGTCTCAAGTCGC	unknown
GCGATAGTCACCATCGTGAC	GTGTGTCTGAGAGAGTCTCTGACAGAGA
GCGATAGTCACGAGGAGTCA	unknown
GCGATAGTCAGTCGTCGATC	unknown
GCGATCGTACCGTCCGCTCT	unknown
GCGATCGTACCTTGACTCAA	unknown
GCGATCGTACGCTTAGATCT	unknown
GCGCACCAGGTCGACATCGA	unknown
GCGCAGCACCGCAACTATTG	unknown
GCGCCTAGCCACGACGTCCA	unknown
GCGCCTAGCCATTAAGATAA	GTGAGTGTCAGTGTCAGTCACAGACTGT
GCGCCTAGCCGATTGATGGC	unknown
GCGCGCCGAGGAGACAACGG	unknown
GCGCGTACGCTTCGCATAAT	unknown
GCGCGTGATGATCGAGCGAA	unknown
GCGCGTGATGTTCTATCAGC	unknown
GCGCTGTGCCAGTTGTCGAA	unknown
GCGCTGTGCCTCCTGATCAA	CGAGTCAGTCTGGCTGTCTGACTCTCAC
GCGCTGTGCCTCCTGGTCGG	unknown
GCGGAACTTGCGATTGATAA	GAGTCACCTCTGAGTGTCTCAGAGACTG
GCGGAACTTGTTACCAAGGT	unknown
GCGGAGCCATGATATGGCAA	unknown
GCGGAGCCATGGAGTACGTA	unknown
GCGGAGCCATGTCGTCGATC	unknown
GCGGAGTGGAAATGCCAGTT	unknown
GCGGCGCACTGTAGACGGAG	unknown
GCGGCGCACTTAGTTGTCAC	unknown
GCGGTGCAGAATGTCTGCCA	unknown
GCGTAAGTAGCTTCCGATAA	CTCACTCTTCTCACTGTCAGAGACAG
GCGTAAGTAGGCAACAGAAC	unknown
GCGTAAGTAGGGAGCAACAG	AGGTGTCTGTGTCTGTGTCAGTCTCTCT
GCGTAGGCTTATCGAGCGAA	CGACTGTGACTCTGACAGTGAGT
GCGTAGGCTTCTAGTGTAAC	unknown
GCGTAGGCTTGCTGCTCTTC	unknown
GCGTAGGCTTTCCGAAGATT	unknown
GCGTATAATCCGATTGATAA	unknown
GCGTATAATCGACTATCACA	unknown
GCGTATGCGGCAGTCCAGGA	unknown
GCGTATGCGGGTTGTCTGAC	unknown
GCGTATGCGGTCTTGGAGAC	unknown
GCGTATGCGGTTGACATCTC	unknown
GCGTTAACGCACGGCGAGGC	GACTCTCACTCTGTGTGAGAGACTGTCT
GCTAAGGTTCACTTCAACAC	unknown
GCTAAGGTTCCATTCCGGCT	unknown
GCTAAGGTTCGTTAAGGTGA	unknown
GCTAAGGTTCTGGACGTGAC	unknown
GCTAAGTACTCATGGACTCC	unknown
GCTACAATCACCTTAAGGCT	unknown
GCTACAATCACTTCTTCGTA	unknown
GCTACCATACAGTCTATCGT	unknown
GCTACCATACGTTACCACAT	unknown
GCTACCATACTTCTCACTCC	unknown
GCTACGTCATCGAGGAGTCA	unknown
GCTACGTCATGCAACTATTG	unknown
GCTAGAAGTTTGGACGTGAC	unknown
GCTAGAAGTTTGTGTGTAAC	unknown
GCTAGTCTCGTCTTGGAGAC	unknown
GCTATGCGCTCCGTGCAACC	unknown
GCTATTACATAGGTTAGGAG	unknown
GCTATTACATGGTGCAACCT	AGTGAGTGTCAGAGACTCTGTCTGACAG
GCTCAGCTGGGTCAGTACCA	unknown
GCTCAGCTGGTACGGACTCT	GACAGACAGTCACACTGAGAGTCAGTGT
GCTCGGTATGGTACATAGGC	unknown
GCTCGTTAGTCGTTCTACGA	unknown
GCTCTACATACAAGCTGAAG	unknown
GCTCTACATACACTCAGTCA	TGTCTCACTGTGAGTCTGAGTGTGTCTG
GCTCTCGGTTAGAATTCAGT	CGTGTCAGACAGTGTGTGTGAGT
GCTCTCGGTTTCCTCCTGGC	unknown
GCTCTTCAATTATTCATATA	unknown
GCTGCTCTTCATAACATACG	unknown
GCTGCTCTTCATCTCGCTGC	unknown
GCTGTGAGACGAGGTGCCGC	GTGACAGTGTGTGACAGTCTCACAGTCT
GCTTAATCAAACTGCACAGG	unknown
GCTTAATCAACTAAGATATT	unknown
GCTTAATCAACTTCCTACAG	unknown
GCTTAATCAAGACCAGTACG	unknown
GCTTAATCAAGATATGGCAA	unknown
GCTTAATCAAGTTGTCTGAC	unknown
GCTTAGATCTCCGGTCACTA	unknown
GCTTAGATCTGTTAAGGTGA	CGACTGTGTCTCTGACAGTCTCAG
GCTTAGTCGGATGTTCTATA	unknown
GCTTAGTCGGTAGCGCACGT	unknown
GCTTATTCTTGGCTCCAAGC	unknown
GCTTCAGCGCATTATTGTGC	unknown
GCTTCAGCGCTGCAAGATAC	unknown
GCTTCCTAACATGATCATTA	unknown
GCTTCCTAACCGATACTAGC	unknown
GCTTGACAATAACTTGCACC	GACTGTGTCTCTGACAGTCTCAGAGTGT
GCTTGACAATATTAACCGGC	unknown
GGAACGTGCCTACGCCGATT	unknown
GGAAGCACTAACGGTACCTC	unknown
GGAAGCACTAAGATTGAGAG	unknown
GGAAGCACTACGTATTGCTC	unknown
GGAAGCACTATCCTGGTCGG	unknown
GGAAGCATGTTAGGCTCAGG	unknown
GGAATGCCACGCTGCTCTTC	unknown
GGACACTCTTCTGCAGGATA	unknown
GGACATGAGAAGCCTCCTAT	unknown
GGACATGAGAATGTCCGTGC	unknown
GGACATGAGACGTATTGCTC	GCGAACCTGTCTCAGTCTGCCACACTCA
GGACGCCATAGACTATCACA	unknown
GGACGCCATATCGATGCGCG	unknown
GGACGTGGAAAGCAGGCAGC	unknown
GGACGTGGAAGCCTCTGGCT	CGACTGTGTCTCCGACAGTCT
GGAGAATATACTTGCCGCGC	unknown
GGAGATTAATTCCAGGTACT	unknown
GGAGATTAATTGTAAGAGCT	unknown
GGAGCAACAGTGACGTCCTT	unknown
GGAGCAACAGTGATGACGTA	unknown
GGAGCAACAGTTCGCATAAT	GACTCTCACTCTGTGTGAGAGACTGTCT
GGAGCTATGGATTATTGTGC	unknown
GGAGCTATGGGTCAGTACCA	unknown
GGAGGTCCAAACGACAATAT	unknown
GGAGGTCCAAGCCAGCTTCG	unknown
GGAGGTCCAATATCGGAATA	unknown
GGAGGTCCAATCCTCCTGGC	unknown
GGAGGTTGGTACGGCGAGGC	unknown
GGAGGTTGGTCGATTGATAA	GACAGACTGAGGCTATGTGTGACACTCT
GGAGGTTGGTTGCGGTTACG	unknown
GGAGTACGTAACGAGGCCAT	unknown
GGAGTACGTACTCTAAGCAT	unknown
GGAGTACGTATATTCATATA	unknown
GGAGTTCGATACCTCTCCTG	unknown
GGAGTTGACCAATCTACAAG	unknown
GGAGTTGACCAGTGGTGGTA	unknown
GGATACTGATAATCAGTGGA	unknown
GGATATCTCCACATATGCGA	unknown
GGATGTGCTATCAATGGTGG	unknown
GGATTCGGCCAATCAGTGGA	TACCTGTCTCACTGAGAGTCTGTGTGTG
GGATTCGGCCGGAACGTGCC	unknown
GGCACCTTGCCGAGGAGTCA	unknown
GGCACCTTGCCGATATGTGC	unknown
GGCACCTTGCCTAGACACTT	unknown
GGCACGACGTAAGTTGGAGG	unknown
GGCACGTTCGTCTCGCGACC	unknown
GGCACTGAGCCAGTGTATGC	unknown
GGCACTGAGCTGCAAGATAC	unknown
GGCACTTCCACGCTGAATTC	unknown
GGCACTTCCACTAAGAGTCC	unknown
GGCACTTCCATATAGAAGCT	unknown
GGCAGACCTACGATACTAGC	unknown
GGCAGACCTAGTCGCGATTC	unknown
GGCAGGAGCTCTAGGCCACG	unknown
GGCAGGAGCTTCAGATAGAT	unknown
GGCATACGTTAGTTCCTGTC	GACTGTGTCTCTGACAGTCTCAGAGTGT
GGCATACGTTCCTGTGAAGT	unknown
GGCATACGTTGCAACAGAAC	unknown
GGCATCGATAAAGATCAATT	unknown
GGCATCGATAACCGACATTA	unknown
GGCATCGATACAGCGAAGTC	unknown
GGCATCGATATCTCGCGACC	unknown
GGCATGACCAACGACGTCCA	unknown
GGCATGACCAAGAATTCAGT	unknown
GGCATGACCATAACATAGCA	unknown
GGCATGACCATATGAACAGC	unknown
GGCATTATCGCCGTGCAACC	unknown
GGCATTATCGTTCCACTACA	unknown
GGCATTCGAACGGACTGAGG	unknown
GGCATTCGAACTTGACTCAA	unknown
GGCCGATACGCTTACCGGTG	unknown
GGCCTGCACACTCGCAGGTC	unknown
GGCGGCATGAACGTTGAATA	unknown
GGCGGCATGACAGTCCAGGA	unknown
GGCGGCATGACTAAGAGTCC	unknown
GGCGTCAGTAAATTAATCTG	unknown
GGCGTCAGTACCTGCTTAGT	unknown
GGCTATATAAGCTGCTCTTC	unknown
GGCTATCGCGACACACCAGA	unknown
GGCTATCGCGCACCGCTAGT	unknown
GGCTATCGCGCGCTGAATTC	CTGTCTCACTGAGAGTCTGT
GGCTCCGCTGGGCTCCAAGC	unknown
GGCTCCGCTGTAGTTGTCAC	GACAGACTGAGACTCAGTGTGACACTCT
GGCTCGTATACGATTCCGGC	GACTGTGACTCTGACAGTGAGTCTGTCT
GGCTCGTATAGCCGCAATAG	unknown
GGCTCGTATAGTGTGAAGTT	unknown
GGCTCGTATATTGTGGCATC	unknown
GGCTTCGTCGCTCGCAGGTC	unknown
GGCTTCGTCGGACGAAGACT	unknown
GGCTTCGTCGGATATAGCGG	GTCTGTGACAGTCTGTCTGAGTCTGTCT
GGCTTCGTCGTCGCATCTTG	unknown
GGCTTGGTGCTAGAAGACTC	unknown
GGCTTGGTGCTTCTCCTGTA	GAGACTGTGTCTGTGTCAGTCTCTCTCA
GGTACACCACAGTTGTCGAA	unknown
GGTACTCTGCACAGTTCATT	unknown
GGTACTCTGCGGAACGTGCC	unknown
GGTACTCTGCGGTTGGTAAC	unknown
GGTAGCTCATTCACGAATCC	unknown
GGTAGGATACGACCAGTACG	unknown
GGTAGGATACTTGATCTTAA	unknown
GGTATATGCCTTCAGTGCGG	unknown
GGTATCCTTATGCTGCAGTA	GAGTGAGACTGTCAGACTGTCTGTCAGA
GGTATCCTTATTGACATCTC	unknown
GGTCCGGTGTAAGTTGGAGG	unknown
GGTCCGGTGTGCCAGCACGT	CGCCTGTCTGTGGGAGACTCTCTGTGTC
GGTCCGGTGTGGTGCAACCT	unknown
GGTCCGGTGTTAGCTGCTAC	unknown
GGTCTGGTCAGCTGTGAGAC	unknown
GGTCTGGTCATCCAGGTACT	unknown
GGTGAGGTGCCGTATTGCTC	unknown
GGTGCAACCTAAGTTGGAGG	unknown
GGTGCATTGGCTCACAGCGG	unknown
GGTGCATTGGTGACGTCCTT	unknown
GGTGCGCGTAGTGTCACGAG	unknown
GGTGGAAGGTCGCACTGGAT	unknown
GGTGGAAGGTGCTCGGTATG	unknown
GGTGGAAGGTTCCTCGTGCG	unknown
GGTGTTATAATTGACATCTC	unknown
GGTTACAGTAGCTAGTAGAA	unknown
GGTTACAGTAGTGAACGAGA	unknown
GGTTACAGTATCCGACCGTA	unknown
GGTTAGTGGCGCGAATCGAC	GTGACAGTGTGAGACAGTCTCACAGTCT
GGTTGAGCCGAAGATTAACC	unknown
GGTTGAGCCGTGTTCACTAG	unknown
GTAACCACCGCTCACTGTAG	unknown
GTAACCACCGGAACGCCGTG	unknown
GTAACCACCGGTAATACGTC	unknown
GTAACCTTGTTGACTTCGTA	unknown
GTAACGACGCCACCGCTAGT	unknown
GTAACGACGCGTCACGTGCT	unknown
GTAACGGATGCATGCTGACT	CGTGACTGACTGTGTGTCTCTCTGTCT
GTAACGGATGCTTCAATAAT	unknown
GTAACGGATGCTTCCGATAA	unknown
GTAATATTACACAGTCCACC	unknown
GTAATATTACCTCGCAGGTC	GAGACTGTGTCTGTGTCAGTCTCTCTCA
GTAATTGACAACACACCAGA	unknown
GTAATTGACAGCTGCTCTTC	unknown
GTAATTGACAGGCACTGAGC	unknown
GTAATTGACATCTTCATCTC	unknown
GTACATAGGCCCTGTGAAGT	unknown
GTACATAGGCGCCTCCGGTC	unknown
GTACATAGGCTTAATTGCTC	unknown
GTACCGCAGCCATCGGCATG	unknown
GTACCGCAGCGACTGTTCCT	unknown
GTACCGCAGCGGCTTCGTCG	unknown
GTACGAGTTGAATGCCAGTT	unknown
GTACGAGTTGAGTAGTAATA	unknown
GTACGAGTTGGCCTCCGGTC	unknown
GTACGAGTTGGTTGTCTGAC	unknown
GTACGAGTTGTACGCCGATT	unknown
GTAGACGGAGATTAACCGGC	unknown
GTAGACGGAGCCGAGCGATT	unknown
GTAGACGGAGCGTATCGCCT	unknown
GTAGATCATGAGTGGACACC	unknown
GTAGATCATGATTAAGATAA	unknown
GTAGATCATGCTTCCGATAA	unknown
GTAGATCATGGTTACCACAT	unknown
GTAGGATCAGATAACATACG	unknown
GTAGGATCAGATCAGTTAAC	unknown
GTAGGATCAGCAACTCGTCG	unknown
GTAGGATCAGCATAGGACTG	unknown
GTAGGCGAGGAAGGAATGTA	unknown
GTAGGCGAGGATCCACTAAG	unknown
GTAGGCGAGGGCGGTGCAGA	unknown
GTAGGTACCTCCGAGCGATT	GAGACTGTGTCTGTGTCAGTCTCACTCA
GTAGGTACCTCTCACTGTAG	unknown
GTAGGTACCTGTTGTTCTCT	unknown
GTAGTACCGGCTTGACTCAA	unknown
GTAGTACCGGGCGAACACGG	unknown
GTAGTACCGGTAGTCGGAAT	unknown
GTAGTGCCAACCTGCGAACA	unknown
GTAGTGCCAAGTAGACGGAG	unknown
GTAGTTCTAGGTCTCACAGT	CTGACAGAGTGTGTCACTGAGT
GTAGTTCTAGTGCAAGATAC	unknown
GTATACTTAGAAGCGCCGTA	unknown
GTATACTTAGCGGACTGAGG	unknown
GTATACTTAGCTAAGAGTCC	unknown
GTATACTTAGGCCAGCTTCG	unknown
GTATACTTAGTTGACATCTC	unknown
GTATATGAAGCAGCGAAGTC	unknown
GTATTCTATGATCTCGCTGC	CGACTGTGTCACAGAGTCACAGTC
GTATTGGCTAGCTGTGAGAC	unknown
GTATTGGCTAGGCACTGAGC	unknown
GTATTGGCTATCTGTTCATA	unknown
GTCAAGCAGAATATTCTCAC	unknown
GTCACTAGGAGGCTATATAA	CAGTGTCACAGAGAGTCTCTGACTCAG
GTCAGGATCGTTAACGTAGG	unknown
GTCAGGTCGTAAGTCGATCC	unknown
GTCAGGTCGTCGGACTGAGG	unknown
GTCAGTACCATATCGGAATA	unknown
GTCCAGACGAACATCATTGC	unknown
GTCCAGACGATGTGTGTAAC	unknown
GTCCATATGGAGTTCCTGTC	unknown
GTCCTAGTGCCTCAAGTCGC	unknown
GTCCTAGTGCTCCTGATCAA	unknown
GTCCTTGCACAACGAGGTCC	unknown
GTCCTTGCACGCGGTGCAGA	TTGAGTCTGTGTCTGTGTCAGTCTCTCT
GTCCTTGCACGCGGTGCAGA	CAGTCTCTGTGTGTCTGACACTCACAGT
GTCCTTGCACGCTTAGATCT	unknown
GTCGAAGTCAATAGAGAGCC	unknown
GTCGAAGTCACGCTGAATTC	unknown
GTCGCCTTGATGACGTCCTT	CTGACAGAGTGTGTCACTGAGTCTGTCT
GTCGGACCTCCGCCTCATCT	unknown
GTCGGACCTCCTCGATTGGT	unknown
GTCGTCACGGAAGATTAACC	unknown
GTCGTCACGGAATCTACAAG	unknown
GTCGTCACGGGCTCGGTATG	TGGCTCAGTCTGTCACACTCACTGAGTG
GTCGTCGATCATGTCCGTGC	unknown
GTCGTCGATCCAAGCTGAAG	unknown
GTCTAATGCAATAGAGAGCC	unknown
GTCTAATGCACTTCGGCCGG	unknown
GTCTAATGCAGGAGTACGTA	GACTGTCTGTGACTGTGTCACACACTGA
GTCTACCTTCCGAATATAGG	unknown
GTCTACTGACCAGGAACGAG	GACACAGTCAGAGACACTCAGTCACACA
GTCTCACAGTCTCTGTCTCC	unknown
GTCTGAGCACAAGATCAATT	unknown
GTCTGGTACGACATGCCTGT	unknown
GTCTTCGGCTCCGAATCAGT	unknown
GTCTTCGGCTTTAACGTAGG	unknown
GTGAACGAGACTGACCTGGT	unknown
GTGAACGAGAGCTGCTCTTC	unknown
GTGAACGAGAGTCGCGATTC	unknown
GTGAACGAGAGTTGGATCCT	unknown
GTGAACGAGATAGTTAGACG	unknown
GTGAAGATCTACGGCCTGTA	unknown
GTGAAGATCTCATCGGCATG	unknown
GTGAAGTCGGGATAATGATG	AGTGTCACAGAGAGTCTCTGACTCAGAG
GTGACAGCGCAGCAGGCAGC	unknown
GTGACATACACCAGATTCGG	unknown
GTGACATACAGCAGGTATCC	unknown
GTGACATACATCGCATCTTG	unknown
GTGAGCGGAACAGTGTATGC	unknown
GTGAGCGGAAGTGCGAACAT	ACTCAGAGAGTGACTGTGACTCTGTCTG
GTGAGCGGAATAGTCGGAAT	unknown
GTGAGTCATAAAGGAATGTA	GAGACTGTGTCTGTGTCAGTCTCTCTCA
GTGAGTCATAAAGGAATGTA	GAGACTGTGTCTGTGTCAGTCTCTCTCA
GTGATATAGTCTTCGATGGT	unknown
GTGATCGCATCGGACCACCT	unknown
GTGATCGCATTATATGCGTT	unknown
GTGCCACCTGGCAGGTATCC	unknown
GTGCCGTGTTACGACTATTA	unknown
GTGCCGTGTTTTAACGTAGG	unknown
GTGCGAACATACGACTATTA	unknown
GTGCGAACATCGGACTGAGG	unknown
GTGCGAACATGTACATAGGC	unknown
GTGCGAACATTCTTCATCTC	unknown
GTGCGGTTCAATGATCATTA	unknown
GTGCGGTTCAGGACACTCTT	unknown
GTGCGTATGTAATTCCAACC	unknown
GTGCGTATGTCAGGAACGAG	GAGTGAGACTGTCAGACTGTCTGTCAGA
GTGCGTATGTGAGGTGCCGC	unknown
GTGCGTATGTGCGACAGTGT	unknown
GTGCTAAGAATTGAAGAAGC	GTGACAGTGTGAGACAGTCTCACAGTCT
GTGGACAGGAGTTACGCGTC	unknown
GTGGAGTGTCGTCGCGATTC	unknown
GTGGCAGGTGCTAGGCCACG	unknown
GTGGCAGGTGCTCTAAGCAT	unknown
GTGGCAGGTGGTCGCGATTC	unknown
GTGGTGCATCGTGGACAGGA	unknown
GTGTAGTACTACACACCAGA	unknown
GTGTAGTACTCGGACGGATT	unknown
GTGTCACGAGGGCTATATAA	unknown
GTGTCGCGGAAACCTTGCGG	unknown
GTGTCGCGGAAAGGATTGAT	unknown
GTGTCGCGGACTTACCGGTG	unknown
GTGTGAAGTTAGACTTACGT	unknown
GTGTGAAGTTTCGCATCTTG	unknown
GTGTTAACTAAGACCGTCGT	CTGACAGAGTGTGTCACTGAGTCTCTC
GTGTTAACTACATTCCGGCT	unknown
GTGTTAATGTTGGTATTGTC	unknown
GTGTTATCCGTAGCGCACGT	unknown
GTGTTGGAACTCCTCCTGGC	unknown
GTTAACAACTAGATTGAGAG	unknown
GTTAACAACTCCGAGCGATT	unknown
GTTAAGGCTTCCTTAAGGCT	unknown
GTTAATAATCACGACAATAT	unknown
GTTACCACATCCATCGTGAC	unknown
GTTACCACATTAGTCGGAAT	unknown
GTTATAACGCCAGTGTATGC	unknown
GTTATAGATGATCAGAGTCA	GTGTGTCTGTGTCTGTCAGTCTCTCACT
GTTATAGATGCGATTGATAA	unknown
GTTATAGATGCTTCGGCCGG	unknown
GTTATAGATGCTTGACTCAA	unknown
GTTATAGATGGCTCAGCTGG	unknown
GTTCGATAACAGTCGACCAT	unknown
GTTCGATAACATAACATACG	unknown
GTTCGATAACGTGGCAGGTG	unknown
GTTGACGGCTCGTTCGATGG	unknown
GTTGACGGCTGACTCTCCAA	GAGTGAGACTGTCAGACTGTCTGTCAGA
GTTGCATGGTTGCTGCAGTA	unknown
GTTGCGCCGGAGAGAGTCGC	unknown
GTTGCGCCGGCACCGCTAGT	unknown
GTTGCGCCGGTACTAATGGC	unknown
GTTGCTCCTTCGATTGATAA	TGACAGACAGACTGAGAGTCTGAGTCTG
GTTGGATCCTAATTCGAAGG	unknown
GTTGGATCCTGCTCAGCTGG	unknown
GTTGGATCCTTGACGTCCTT	unknown
GTTGTATGCAAGAGCGGCAA	unknown
GTTGTATGCAGTTACCACAT	CGTGTGACAGAGAGTGTCTCTGA
GTTGTATGCATACAGTACGC	CGTGACTGTCTGTGACTCTCACAG
GTTGTCTGACGTTGCGCCGG	unknown
GTTGTCTGACTTAACGTAGG	unknown
TAACATCTAGGCAGGTATCC	unknown
TAACATTGTGCCTGTGAAGT	unknown
TAACTTCATGAAGGAATGTA	unknown
TAAGCGTGGCGATAATGATG	unknown
TAAGCGTGGCGTTGCGCCGG	unknown
TAAGGAGAAGCCGAGCGATT	unknown
TAAGGAGAAGGAAGACAGAC	unknown
TAAGGTATTCAGTCGACCAT	unknown
TAAGGTATTCGGAACGTGCC	CGAGACTGAGTCTGACTGTCAGAGACAG
TAATAGTTAAGGCCTGCACA	unknown
TAATATTCAGCTCGCAGGTC	unknown
TAATCCGTCGAGTGGTGGTA	unknown
TAATCCGTCGCTAGGCCACG	GAGACTGTGTCTGTGTCAGTCTCTCTCA
TAATCCGTCGGTCCAGACGA	unknown
TAATCGGTGCAGTGGACACC	unknown
TAATCGGTGCCAGTCCAGGA	unknown
TAATCGGTGCCCAGATTCGG	GAGACTGTGTCTGTGTCAGTCTCTCTCA
TAATCGGTGCTCGATGCGCG	GTGTGAGTGTGACTCTGAGAGACTCTCT
TAATCTAATATAGAAGACTC	unknown
TAATTCGCTGAAGGAATGTA	unknown
TAATTCGCTGTTAATTGCTC	TGTCTCACTGAGAGTCTGTGTGTGTCTG
TAATTGAACGGTGTGAAGTT	unknown
TAATTGTATAAAGATCAATT	unknown
TACAAGCACCTAGTTGTCAC	unknown
TACACTAGCCAATACTCGAT	unknown
TACAGCATCACTGTGAGCAG	unknown
TACAGTACGCTAGTCGGAAT	unknown
TACAGTACGCTAGTTAGACG	unknown
TACAGTACGCTTCCACTACA	unknown
TACATGTGCCTAAGCGTGGC	GTGACAGTGTGAGACAGTCTCACAGTCT
TACATGTGCCTCATCGGATT	unknown
TACATGTGCCTCTAATGACG	unknown
TACCACACGGCTAAGATATT	unknown
TACCACACGGGCGGTGCAGA	unknown
TACCACACGGTATCATCTCT	unknown
TACCATGACTATCGGACAAG	unknown
TACCGTCAGCATGGAAGGCC	unknown
TACCGTCAGCGCGAATCGAC	unknown
TACCGTCAGCGCGCAGCACC	CGAGACTGTGTCTGTGTCAGTCTCTC
TACCGTCAGCTTGAGCCTGA	unknown
TACCTCGTACACGCCTCAGT	unknown
TACCTCGTACCGCCTCTCGG	unknown
TACCTCGTACGCGACAGTGT	unknown
TACCTCGTACGTTGTCTGAC	unknown
TACCTCGTACTGCTCAGAAG	unknown
TACGAAGTGCCATGGACTCC	unknown
TACGATGCACAAGATTAACC	unknown
TACGATGCACGGCCTGCACA	CGTGACAGTGTGAGACAGTCTCACAG
TACGATGCACTCCGACCGTA	unknown
TACGCATTAACATCAGTTGG	unknown
TACGCATTAACTTGTCTAGT	unknown
TACGCCGATTGACTGTTCCT	GTGTCTGAGTCTGAGTCTGTCTGTGACT
TACGGACTCTACCAAGCCAG	unknown
TACGGACTCTCGTATTGCTC	unknown
TACGGACTCTGATGAGAGGT	unknown
TACGGTTGCAGCCTCCGGTC	unknown
TACGTAACAGATCAGAGTCA	unknown
TACGTAACAGCATTCCGGCT	unknown
TACGTAACAGTCTTCATCTC	unknown
TACGTTATGGTCGACATCGA	unknown
TACTAATGGCAGACCGTCGT	unknown
TACTAATGGCCGGACCACCT	unknown
TACTATCCTCGACTATCACA	unknown
TACTATCCTCGATTGATGGC	unknown
TACTCAGGAAGACGAAGACT	unknown
TACTGCAATGCGCACTGGAT	unknown
TAGAACTCGAAATACTCGAT	GTGAGTGTCAGTGTCAGTCACAGACTGT
TAGAACTCGAAATACTCGAT	GTGAGTGTCAGTGTCAGTCACAGACTGT
TAGAACTCGAAATACTCGAT	GTGAGTGTCAGTGTCAGTCACAGACTGT
TAGAACTCGACTCAAGTCGC	unknown
TAGAACTCGAGGAGGTTGGT	unknown
TAGAACTCGAGTCGGACCTC	unknown
TAGAATGATTGGAGTACGTA	unknown
TAGAATGATTTAACATAGCA	unknown
TAGATAGCGTACACACCAGA	GAGAGTGTCAGTCTGACACACACTCTGA
TAGATCTAATGTCGCGATTC	unknown
TAGCGCACGTGCCTCTGGCT	unknown
TAGCGCACGTGCGTACAACT	unknown
TAGCGCACGTGTTACCACAT	unknown
TAGCGGTTGCCGGCAGAGTC	unknown
TAGCTGCTACTAGTCGGAAT	unknown
TAGGACAGCCAAGATTAACC	unknown
TAGGACAGCCCCATAAGGAG	CAGTGTCACAGAGAGTCTCT
TAGGACAGCCCTAAGATATT	unknown
TAGGACAGCCTACAGTACGC	unknown
TAGGCTCAGGCTTGTCTAGT	TGACGTGTGTCTGAGAGAGTCTCTGACA
TAGTACAATTAGCACAGTTG	unknown
TAGTACAATTGCCAGCTTCG	unknown
TAGTACAATTTGACTTCGTA	unknown
TAGTCGCGCCAACGAGTATT	unknown
TAGTCGCGCCGATGGAGTGC	unknown
TAGTCGCGCCGTAATACGTC	unknown
TAGTCGGAATGACCAGAATA	TGTCTCACTGAGAGTCTGTGTGTGTCTG
TAGTCTACACAATAATGCAC	unknown
TAGTTAGACGACATATGCGA	unknown
TAGTTAGACGAGTGGACACC	unknown
TAGTTAGACGCGTATTGCTC	unknown
TAGTTGTCACAAGATCAATT	unknown
TAGTTGTCACCCGAATCAGT	GTCTGTGACTCTGACAGTGAGTCTGTCT
TAGTTGTCACCCTGCTTAGT	TGTCTCACTGAGAGTCTGTGTGTGTCTG
TAGTTGTCACGTCAGTACCA	unknown
TATAAGTATTACGACTATTA	unknown
TATAATTAGGATACTCCTAC	CGAGACTGAGTCTGACT
TATACAATTACAGCGAAGTC	unknown
TATACAATTAGTGAACGAGA	unknown
TATACATTCGGTTGGATCCT	unknown
TATAGAAGCTACATAGGTGG	CGAGTGAGACTGTCAGACTGT
TATAGAAGCTACATAGGTGG	GAGTGAGACTGTCAGACTGTCTGTCAGA
TATAGAAGCTACGACAATAT	CTGTCTCACTGTGTGTC
TATAGAAGCTCGATAAGCAC	unknown
TATAGAAGCTGACTCACCTT	unknown
TATATCACACTAGGCTCAGG	unknown
TATATCACACTGCTGCAGTA	unknown
TATATGCGTTATGATCATTA	CAGACAGACTCTCAGTGACAGA
TATATGTTATAGTCTATCGT	unknown
TATCAATGCAAGAGAGTCGC	unknown
TATCAATGCAAGTGTTGCTT	unknown
TATCAATGCAGAACGCCGTG	unknown
TATCACTGACCAAGCTGAAG	unknown
TATCACTGACTCTTGGAGAC	unknown
TATCATCTCTCGTTCGATGG	CGTGACTGTCTGTGACTCTC
TATCATCTCTGAAGACAGAC	unknown
TATCATCTCTGTCCAGACGA	GACTGTGTGTCAGAGACACTGACACTCT
TATCATCTCTGTCCAGACGA	GACTGTGTGTCAGAGACACTGACACTCT
TATCATCTCTGTCCAGACGA	GACTGTGTGTCAGAGACACTGACACTCT
TATCATCTCTGTCCAGACGA	GACTGTGTGTCAGAGACACTGACACTCT
TATCCACAGTCGTATTGCTC	unknown
TATCCACAGTTAATCGGTGC	unknown
TATCGCTAGCTATCGCGCCA	unknown
TATCGGAATAAAGATCAATT	GAGTCACTTAGAGAGTCAGAGACTGTGT
TATCGGAATACCGTGCAACC	TGACAGAGTGTGTCACTGAGTCTCTCTG
TATCGGAATAGCGCAGCACC	unknown
TATCGGAATAGTTGTTCTCT	unknown
TATCTACACACATCAGTTGG	unknown
TATCTACACAGCGAATCGAC	unknown
TATCTACACAGTAGACGGAG	unknown
TATCTCGGCTAGATTGAGAG	unknown
TATCTCGGCTTGGATTAGAC	GACTCTCTGAGAGAGTCTGAGACTGAGT
TATCTCGGCTTGGATTAGAC	GCGACTCTCTGAGAGAGTCTGAGACTGA
TATCTTGGTCCGACGGACGA	CTGTGACACTCAGTGTGTCT
TATCTTGGTCGAGACAACGG	unknown
TATGAACAGCAATCTACAAG	unknown
TATGAACAGCATCGAGCGAA	unknown
TATGAACAGCGTGGACAGGA	unknown
TATGAACAGCTAATCGGTGC	unknown
TATGAACAGCTCTAATGACG	GTCTGAGACTGAGTCAGTGTGTGTCAGA
TATGCCTGATAGTTGTCGAA	unknown
TATGCCTGATATATTCTCAC	unknown
TATGCCTGATTGAGGTGGTT	unknown
TATGGCATAGAGTCTATCGT	unknown
TATGGCATAGATTAAGATAA	unknown
TATGGCATAGCAACTCGTCG	unknown
TATGTATGGCCTTGTCTAGT	CGTGACAGTGTGAGACAGTCTCACAGTC
TATTACTCTCAGGCACACCT	GTCTCTGAGTCTGAGTCTGTCTGTGACT
TATTACTCTCTTGAAGAAGC	CTCTGTCAGTGTCACAGTCACAGTG
TATTATATGGGCCTCTGGCT	unknown
TATTCATATAAGTCGTCCTA	TCTGTCAGTCACACACTGTCTCTCTCTG
TATTCTTAATAGTGGACACC	unknown
TATTCTTAATCGATCACGAT	unknown
TCAACCGCTCATGTCTGCCA	unknown
TCAACGAACCAAGTTCGACC	CGAGACTGTGTCTGTGTCAGTCTCTCTC
TCAACGAACCCTTCGATGGT	GAGACTGTGTCTGTGTCAGTCTCTCTCA
TCAATCGTCCTCACGAATCC	unknown
TCAATGGTGGACTGGTAAGA	GACTGTGACTCTGACAGTGAGTCTGTCT
TCACGAATCCCTCACTGTAG	unknown
TCACGAATCCCTGACCTGGT	unknown
TCACGAATCCGTCACGTGCT	unknown
TCACGAATCCTCAATGGTGG	unknown
TCACGCCGCGACATGCCTGT	unknown
TCACGCCGCGCTATCACTAG	unknown
TCACGCCGCGGGCTCCAAGC	unknown
TCACGCCGCGTGCTCAGAAG	AGAGAGTCTCACTGTCAGTGACTGACTG
TCACGGCGGCCATGCTGACT	unknown
TCACTGCTTCATCAGTTAAC	unknown
TCACTGCTTCTAGCTGCTAC	unknown
TCAGATAGATGGTGCAACCT	unknown
TCAGCGCAATAGACTTACGT	unknown
TCAGCGCAATGTAATACGTC	unknown
TCAGCGCAATGTACATAGGC	unknown
TCAGGTAAGTCAGCGAAGTC	unknown
TCAGGTAAGTCTAAGAGTCC	unknown
TCAGGTAAGTCTAAGATATT	unknown
TCAGTACACGGGAGCTATGG	unknown
TCAGTACACGTACAGTACGC	unknown
TCAGTACACGTGACTTCGTA	unknown
TCATCCACCTCAGTCCAGGA	unknown
TCATCCACCTTGTTCACTAG	unknown
TCATCCACCTTTACCAAGGT	unknown
TCATCCTTGGGCTCTCGGTT	unknown
TCATCGGATTGTCCAGACGA	unknown
TCCAATAGAATCCGACCGTA	unknown
TCCAATCTCGACGAGGCCAT	unknown
TCCAGGTACTCGTATTGCTC	unknown
TCCAGGTACTCTTCGGCCGG	unknown
TCCAGGTACTGATTGATGGC	unknown
TCCAGGTACTGCAACTATTG	unknown
TCCAGGTACTTTCAGTGCGG	CGACTGTCTGTGACTGTGTCACACACT
TCCGACCGTATCCTGATCAA	GTGACAGTGTGAGACAGTCTCACAGTCT
TCCGACTTAACAGCAAGCAG	unknown
TCCGACTTAAGCACATAGTA	unknown
TCCGACTTAAGCTCAGCTGG	unknown
TCCGCGGTCGCCTGCTTAGT	unknown
TCCGTCAACGCATGGACTCC	unknown
TCCGTCAACGGGAACGTGCC	unknown
TCCGTCTATAGCCGGTTGTA	unknown
TCCGTGAAGCGACTATCACA	unknown
TCCGTGGCTGGGCTCCAAGC	unknown
TCCGTGGCTGTGGATTAGAC	unknown
TCCTAACAATGATGAGAGGT	unknown
TCCTAACAATGGAGGTCCAA	unknown
TCCTCCTGGCCGGCGATACC	unknown
TCCTCGAGTAATCGGACAAG	CTCACTCTTCTCACTGTCAGAGACAGTG
TCCTCGTGCGACTGGTAAGA	unknown
TCCTCGTGCGCCTGTGAAGT	unknown
TCCTCGTGCGCTATCGCCTT	unknown
TCCTCGTGCGGTCTCACAGT	unknown
TCCTGCGAGACAGCAAGCAG	unknown
TCCTGGATCTCCGAGCGATT	GAGTCACCTCTGAGTGTCTCAGAGACTG
TCCTGGTCGGCCGAGCGATT	CGACTGTGTCTCTGACAGTCTCA
TCCTGGTCGGCCGAGCGATT	GACTGTGTCTCTGACAGTCTCAGAGTGT
TCCTTACCGAGTCGGACCTC	unknown
TCCTTACCGAGTCTCACAGT	unknown
TCCTTACCGATTGACATCTC	unknown
TCCTTATGATTCCTGGTCGG	unknown
TCCTTGCCAGAAGCGCCGTA	unknown
TCCTTGCCAGCGATCACGAT	unknown
TCCTTGCCAGCGGCGATACC	GACAGACTGAGACTCTGTGTGACACTCT
TCCTTGCCAGGTTGGATCCT	unknown
TCGAACGCCAAGAGCGGCAA	CGACTGTGACTCTGACAGTGAGTC
TCGAACGCCAATTACCGCGT	unknown
TCGACACGATATCAGTTAAC	unknown
TCGACACGATGGCACTGAGC	unknown
TCGACAGACCAAGATTAACC	unknown
TCGACAGACCCTCAACATGT	unknown
TCGACAGACCTAAGCGTGGC	unknown
TCGACATCGAATGATCATTA	unknown
TCGACATCGAATTAAGATAA	unknown
TCGACATCGATGGATTAGAC	unknown
TCGACGTCAGGTCTCACAGT	unknown
TCGACGTCAGTATCGCGCCA	unknown
TCGAGAAGTGCAAGAGGTCA	unknown
TCGAGCCTTCAAGTTCGACC	unknown
TCGAGCCTTCCGCCTGGAGA	TGTCTCAGTCAGAGTCAGAGACAGTCAG
TCGAGCCTTCCGGCGATACC	unknown
TCGAGCCTTCGTTGTTCTCT	unknown
TCGAGCCTTCTCCTCGTGCG	unknown
TCGAGCCTTCTGGTATTGTC	unknown
TCGATATCCTGTAGACGGAG	unknown
TCGATATCCTTATCGCGCCA	unknown
TCGATGCGCGCACCGCTAGT	unknown
TCGCATCTTGCTTGCCTACA	unknown
TCGCGGTATTGACCAGAATA	unknown
TCGCTCGGTGGCACTTCACG	unknown
TCGCTTCAAGTTCTCCTGTA	unknown
TCGGCGCTGCAGGTTAGGAG	unknown
TCGTAGATCGCACATGTTAC	unknown
TCGTAGTCGTTAGCGCACGT	unknown
TCGTGACAAGGACCAGAATA	unknown
TCGTGGCAGACTTCTTCGTA	unknown
TCGTGGCAGAGGTATCCTTA	unknown
TCGTGGCAGATCCTCGTGCG	unknown
TCGTTATAGGCGATATGTGC	unknown
TCTAACACGTACGGCCTGTA	unknown
TCTAACACGTCCGAATCAGT	unknown
TCTAACACGTTATGAACAGC	unknown
TCTAACACGTTCACGAATCC	unknown
TCTAATGACGCTTCCTACAG	unknown
TCTACAGTGGCAGGAACGAG	CGAGTGAGACTGTCAGACTGTCT
TCTACAGTGGTTCTATCAGC	unknown
TCTACGGTAACGATTCCGGC	AGTGTGTCAGAGTGGGTCACACTCTCAG
TCTACGGTAAGTGCGAACAT	unknown
TCTCCATGACTATGGCATAG	TGACACTGTCTGAGTGACTCAGTCCGAG
TCTCGCGACCAATAATGCAC	unknown
TCTCGCGACCTCCGTGAAGC	unknown
TCTGAACCGACAAGAGGTCA	unknown
TCTGAACCGAGTTGCGCCGG	unknown
TCTGAATGATACCAAGCCAG	unknown
TCTGAATGATACCGACATTA	unknown
TCTGATAGCGCACCGAGCAT	unknown
TCTGATAGCGCAGTGTATGC	unknown
TCTGATAGCGTTCTCACTCC	unknown
TCTGATCTAACGCCTCATCT	unknown
TCTGATCTAACTCAAGTCGC	CTGTCTCACTGAGAGTCTGTGT
TCTGATCTAAGCTTCTGTAC	unknown
TCTGCGCACGAAGTAAGCGT	unknown
TCTGGATAGTAGACCGTCGT	unknown
TCTGGATAGTCCACTGGATT	unknown
TCTGGCGCATCGGCAGAGTC	unknown
TCTGTAGGCCATGGCGTGCG	unknown
TCTGTTCATACCAGATTCGG	unknown
TCTGTTCATACTTGCCGCGC	AGTGAGTGTCAGAGACTCTGTCTGACAG
TCTGTTCATAGTGAACGAGA	unknown
TCTTACAACGCGTATCGCCT	unknown
TCTTACAACGGGTATCCTTA	unknown
TCTTATGTTAATTAACCGGC	unknown
TCTTCATCTCACGACAATAT	unknown
TCTTCATCTCATCGGACAAG	unknown
TCTTCCACAGGCAGGTATCC	unknown
TCTTCCACAGTGTCAGGCAC	unknown
TCTTCTCGGCGTAGTTCTAG	unknown
TGAACCGGTGACATATGCGA	CGTGACAGTGTGAGACAGTCTCA
TGAACCGGTGACCAATCTAA	unknown
TGAAGCAACCAAGATCAATT	unknown
TGAAGCAACCCGTTCTACGA	AGTGAGTGTCAGAGACTCTGTCTGACAG
TGAAGCAACCCTTCGATGGT	CTGACAGAGTGTGTCACTGAGTCTC
TGAAGCAACCGGAGGTCCAA	unknown
TGAAGGAAGGCTAGACACTT	unknown
TGAAGGAAGGCTATCGCCTT	unknown
TGAAGGAAGGGCTCTCGGTT	unknown
TGAAGGAAGGGTCGTCGATC	unknown
TGAAGTAATTAATCAGTGGA	unknown
TGACAATAATCCTGCGAACA	unknown
TGACAATAATTCCTGATCAA	unknown
TGACACGTTATTAATTGCTC	unknown
TGACCATCCTCCGGTGGACA	unknown
TGACCATCCTGCCGCAATAG	unknown
TGACCGCGCGCCGAGCGATT	unknown
TGACCGCGCGGACTCACCTT	AGTGAGTGTCAGAGTCTCTGTCTGACAG
TGACCTACAGGCTCAGCTGG	unknown
TGACGACCAAAAGCGCCGTA	unknown
TGACGGCCGGAGCGATCCAT	unknown
TGACGTCCTTTTGAGCCTGA	GTGTCTCACTGTGAGTGTGTGAGACTCT
TGACGTCTGATATCATCTCT	unknown
TGACTATCGAATCAGTTAAC	unknown
TGACTGTCAGGACTCTCCAA	AGTGAGAGTCAGAGACTCAGTCTGACAG
TGACTGTCAGGACTCTCCAA	TGTGAGACAGTCACAGTGTGTCTGTCTG
TGACTGTCAGGCAACTATTG	unknown
TGACTTCGTAACCGACATTA	CGAATGGCCTCAAGAGGGC
TGAGACCGGTCTGTGAGCAG	unknown
TGAGACCGGTGTTAAGGTGA	unknown
TGAGCATAACCGTATTGCTC	unknown
TGAGCATAACTTGAAGAAGC	CGTGTGTCTGAGAGAGTCT
TGAGCCAATGACATGCCTGT	unknown
TGAGCCAATGATGATCATTA	AGTGAGTGTCAGAGACTCTGTCTGACAG
TGAGCCAATGGGAGCTATGG	unknown
TGAGCCAATGGGTATCCTTA	CTGACTCACTGAGAGTCTGAGTGTGTC
TGAGCCAATGTGAGGTGGTT	unknown
TGAGCCGCGCAATACTCGAT	unknown
TGAGCCGCGCATCGAGCGAA	unknown
TGAGCCGCGCTACTAATGGC	unknown
TGAGCGGCCGGTGGACAGGA	unknown
TGAGGCCAATTGTCAGGCAC	unknown
TGAGGTGGTTAATTAATCTG	AGTGTGTCAGAGTGTGTCACACTCTCAG
TGAGGTGGTTATTCCGCTCA	unknown
TGAGGTGGTTGAGGTGCCGC	unknown
TGAGTCTAGTCGGACCACCT	unknown
TGAGTCTAGTGCCTCCGGTC	unknown
TGAGTCTAGTGTGAACGAGA	CGACTGTGACTCTGACAGTGAGTC
TGAGTCTAGTTTCAGTGCGG	unknown
TGAGTGGTTGCGCGAGTCGA	unknown
TGAGTTGTGTACACACCAGA	unknown
TGAGTTGTGTAGAGAGTCGC	unknown
TGAGTTGTGTGCACTTCACG	unknown
TGAGTTGTGTGTGAACGAGA	CGTGACAGTGTGAGAC
TGATAGCATGAATTCCAACC	unknown
TGATCGAGGTTCCAGGTACT	unknown
TGATCTAGTGGAGGTGCCGC	unknown
TGATCTAGTGGGCCTGCACA	unknown
TGATGACGTACACCGCTAGT	unknown
TGATGACGTAGCGGTGCAGA	unknown
TGATGATTAAGAGACAACGG	unknown
TGATGTCGATACTACGGTCG	GTGACAGTGTGAGACAGTCTCACAGTCT
TGATGTCGATGCTTCTGTAC	unknown
TGATTACCTTACGTTGAATA	unknown
TGATTACCTTCGTTCAATAA	unknown
TGATTACCTTGAAGACAGAC	unknown
TGATTACCTTGAGGTGCCGC	unknown
TGCAACCGGAGCCGGTTGTA	unknown
TGCAACCGGAGCGAATCGAC	unknown
TGCAAGATACGGAGGTTGGT	ACTCTCACACTCTCTCTGTCAGTCTCAG
TGCACTTATCCGCTGAATTC	unknown
TGCACTTATCGCGAATCGAC	unknown
TGCAGTGGTACCGTGCAACC	unknown
TGCAGTGGTATCGATGCGCG	unknown
TGCAGTGGTATTACCAAGGT	unknown
TGCCTCAGATATACCGAGCT	unknown
TGCCTGCCTCCAATCTCATG	unknown
TGCCTGCCTCGCTGCTCTTC	unknown
TGCGAGCTCTTTACTGCCTT	unknown
TGCTAAGCCGCGATAAGCAC	unknown
TGCTCAGAAGAGAATTCAGT	AGTGAGTGTCAGAGACTCAGTCTGACAG
TGCTCAGAAGCTCACAGCGG	unknown
TGCTCTATTCGTAGTTCTAG	unknown
TGCTCTATTCTGTCAGGCAC	unknown
TGCTGCTGCGCCAGATTCGG	unknown
TGCTGCTGCGCCGAATCAGT	unknown
TGCTGCTGCGTACTCAGGAA	unknown
TGCTGGTGGCGACTCACCTT	unknown
TGGACGTGACAACGAGGTCC	unknown
TGGACGTGACGCTGCTCTTC	unknown
TGGACGTGACGGCACTGAGC	unknown
TGGAGAACTCGATAATGATG	unknown
TGGAGAGAGGACATAGGTGG	unknown
TGGAGCTCAGTGTGTGTAAC	unknown
TGGATTAGACACACACCAGA	GAGTCACCTCTGAGTGTCTCAGAGACTG
TGGATTAGACCGCGACGAGG	unknown
TGGATTAGACGCTCGGTATG	unknown
TGGCATTCACAACGAGGTCC	unknown
TGGCATTCACCGATATGTGC	unknown
TGGCATTCACGAGACAACGG	unknown
TGGCATTCACTAGTCGGAAT	unknown
TGGCATTCACTTGATCTTAA	unknown
TGGCCAGTAACCTGTGAAGT	unknown
TGGCCAGTAAGACTATCACA	unknown
TGGCCAGTAAGTCGTCGATC	unknown
TGGCCAGTAATAATCGGTGC	unknown
TGGCCAGTAATGCAAGATAC	unknown
TGGCCTTACCATTACCGCGT	unknown
TGGCCTTACCGTAGACGGAG	unknown
TGGCCTTACCTGCGGTTACG	unknown
TGGCCTTACCTTACCAAGGT	unknown
TGGCTCAAGGAACTTGCACC	unknown
TGGCTGAACCCGCGAGTCGA	unknown
TGGCTGAACCGCTTAGATCT	unknown
TGGCTGAACCTAGGCTCAGG	unknown
TGGCTTGCCTCAGTGTATGC	unknown
TGGCTTGCCTGCACTTCACG	unknown
TGGTAACCGCGTCCAGACGA	unknown
TGGTACTGCTGATGGAGTGC	unknown
TGGTATTGTCAATCAGTGGA	unknown
TGGTATTGTCCTAGTGTAAC	unknown
TGGTATTGTCGCACATAGTA	unknown
TGGTATTGTCGCGAACACGG	unknown
TGGTATTGTCTCCGTGAAGC	unknown
TGGTGAGCCTCCAGATTCGG	unknown
TGGTTAGGCACATCGGCATG	unknown
TGGTTAGGCATCCGACCGTA	unknown
TGGTTCCACTCGCCTGGAGA	unknown
TGGTTCCACTCTCACTGTAG	unknown
TGGTTCCACTGGAGTACGTA	unknown
TGGTTCCACTTAGTTAGACG	unknown
TGGTTCGGACATGTCTGCCA	unknown
TGGTTCGGACGCCGGTTGTA	unknown
TGGTTCGGACTTCGCATAAT	unknown
TGTAAGAGCTGACATCGGTG	unknown
TGTAAGAGCTTAGTTAGACG	unknown
TGTAATCCATCTCAACATGT	unknown
TGTAATCCATTGCTCAGAAG	unknown
TGTAGAGTCCCAACTCGTCG	unknown
TGTAGAGTCCCGATTCCGGC	unknown
TGTAGCGTAAATACTGAGGA	unknown
TGTAGCGTAACGAGGTTAAC	unknown
TGTAGCGTAATATCGCGCCA	unknown
TGTAGCGTAATGGTATTGTC	unknown
TGTATTCAGACATCAGTTGG	unknown
TGTATTCAGAGTCGCGATTC	TCAGTCAGACAGTGTGACTGTGTCACAG
TGTCCGCGATCGATTGATAA	unknown
TGTCCTACCTGATAATGATG	unknown
TGTCCTACCTTGCTCAGAAG	unknown
TGTCGGAGTGCAAGCTGAAG	unknown
TGTCGGAGTGGCTGTGAGAC	unknown
TGTCGTAGGTATGCGAGCGT	unknown
TGTCTACGCGACCAATCTAA	unknown
TGTCTCATCCCATGCTGACT	unknown
TGTCTCATCCCCTTACCACA	unknown
TGTCTCATCCGTTAAGGTGA	GACTCTCTGTGAGTGTGTGACTCCCTCT
TGTCTGTCCTACTTCAACAC	unknown
TGTCTGTCCTAGCCTCCTAT	unknown
TGTCTGTCCTATCGAGCGAA	unknown
TGTCTGTCCTATTAACCGGC	unknown
TGTCTGTCCTGACATCGGTG	unknown
TGTCTTACGAGACTCACCTT	unknown
TGTGCAGTTGCCAGATTCGG	unknown
TGTGGCCACGTGGACGTGAC	unknown
TGTGTAGCCGCTGCAGGATA	unknown
TGTGTAGCCGTATCGGAATA	unknown
TGTGTGTAACCTATCACTAG	unknown
TGTGTGTAACTAGTTGTCAC	unknown
TGTGTGTAACTATGAACAGC	unknown
TGTTCACTAGTTACCAAGGT	unknown
TGTTCCAGACAGATTGCTCA	unknown
TGTTCCAGACCCGTGCAACC	unknown
TGTTCCAGACCTATCGCCTT	unknown
TGTTCTCCGGGCGCGCCGAG	unknown
TGTTCTCCGGGTATTGGCTA	unknown
TGTTCTCCGGTCTTGGAGAC	CGACTGTGACTCTGTCAGTGAGTCTGT
TGTTCTCCGGTTACTGCCTT	unknown
TGTTGTCGCGCTCACCTAAG	unknown
TTAACCGCGACGATTGATAA	unknown
TTAACCGCGATCCGAAGATT	unknown
TTAACCGCGATGTAAGAGCT	unknown
TTAACCTACCGCTTAGTCGG	unknown
TTAACCTACCGGAGGTCCAA	unknown
TTAACGTAGGGTTGCGCCGG	GACTGTGTCTCTGACAGTCTCAGAGTGT
TTAACGTAGGGTTGCGCCGG	CGACTGTGTCTCTGAC
TTAACGTAGGGTTGCGCCGG	GTGAGTGAGTCTCAGTGACTCTCAGAGT
TTAACGTAGGTTGATCTTAA	TGTGTGTGTCTCACTGAGTCACTCTCTG
TTACGAACCTATACTGAGGA	CGTCTGTGACAGTCTGTCTGAGTCTG
TTACGAACCTGATGGAGTGC	unknown
TTACGTTCAGATGATCATTA	unknown
TTACGTTCAGCATCGGCATG	unknown
TTACGTTCAGCGATATGTGC	unknown
TTACGTTCAGCGATTCCGGC	unknown
TTACGTTCAGGCCAGCACGT	unknown
TTACGTTCAGTCGACATCGA	GACTGTGTGTCAGAGACACTGACACTCT
TTACGTTCAGTCTAATGACG	unknown
TTACTATGTGCGACGGACGA	unknown
TTACTCAGACGTGGACAGGA	TGACAGAGTGTGTCACTGAGTCTCTCTG
TTACTGCTGAACGACAATAT	unknown
TTACTGCTGAGCCAGCTTCG	AGTGAGTGTCAGAGACTCTGTCTGACAG
TTAGGCAACAAGACCGATCG	CTGTCTCAGTCTGTCACACTCACTGA
TTATAGTAATCTCTGTCTCC	GTCACTGTCTCAGTGACAGTCACTGTCT
TTATCAATAACAGCAAGCAG	unknown
TTATCAATAATCTTCATCTC	unknown
TTATGGCCAAAGGCACACCT	GTCTCTGAGTCTGAGTCTGTCTGTGACT
TTATGGCCAAATGATCATTA	unknown
TTATGGCCAAATGTCTGCCA	CTGACAGAGTGTGTCACTGAGTCTCCC
TTATGGTGGTGACTCACCTT	unknown
TTATGTCTAGCGATATGTGC	unknown
TTATGTCTAGTGACGTCCTT	unknown
TTATTATCAGAGACTTACGT	unknown
TTATTATCAGCGATACTAGC	unknown
TTATTCACTCAGAGAGTCGC	unknown
TTATTCGAGGTGCAGTGGTA	unknown
TTATTGCGATATGATCATTA	CGTGTGTCTGAGAGAG
TTATTGCGATCTCTGTCTCC	unknown
TTATTGCGATTCTAATGACG	unknown
TTATTGGACCAATAATGCAC	unknown
TTATTGGACCAGAGAGTCGC	unknown
TTATTGGACCGTTGCGCCGG	unknown
TTCACTGGCGCGATCACGAT	unknown
TTCAGCAACTACTGGTAAGA	unknown
TTCAGCAACTGGAACGTGCC	unknown
TTCAGTAATCGTTACCACAT	unknown
TTCAGTGCGGTCCGTGAAGC	unknown
TTCCAATAACAATGCCAGTT	unknown
TTCCAATAACATGACGGATA	unknown
TTCCAATAACGCAGGTATCC	unknown
TTCCAATAACGGCACTGAGC	unknown
TTCCACTACAACGTTGAATA	unknown
TTCCACTACATTAATTGCTC	unknown
TTCCAGGCCGATTAAGATAA	unknown
TTCCAGGCCGCTTCAATAAT	unknown
TTCCGTCCTCGCGGTGCAGA	unknown
TTCCTACGACACTACGGTCG	unknown
TTCCTCATAGAACTTGCACC	unknown
TTCCTCATAGTACAGTACGC	GTGTCAGACAGTGTGTGTGAGTGAGTCA
TTCGAATCCTAGCACAGTTG	unknown
TTCGAATCCTCCATCGTGAC	unknown
TTCGAATCCTTAGCGCACGT	unknown
TTCGACCGGCTATCATCTCT	unknown
TTCGCATAATACGACTATTA	unknown
TTCGCATAATCGTACCGCGA	unknown
TTCGCCGCGTGACGAAGACT	unknown
TTCGCCGCGTGTCGCGATTC	unknown
TTCGGACACAGATTCAGAGA	unknown
TTCGGACACAGCGGTGCAGA	unknown
TTCGTCGCCAGTCCAGACGA	unknown
TTCGTCTAGCAAGTTGGAGG	unknown
TTCGTCTAGCACCAAGCCAG	unknown
TTCGTGAATATGTATTCAGA	unknown
TTCGTGTACGCAATCTCATG	unknown
TTCGTGTACGCTAGGCCACG	unknown
TTCGTGTACGGCTTAGTCGG	CAGTGTCACAGAGAGTCTCTGAC
TTCGTGTACGTCAGATAGAT	unknown
TTCGTTGTGCCTTCCATCCT	unknown
TTCGTTGTGCTATCGGAATA	unknown
TTCGTTGTGCTCAGATAGAT	unknown
TTCGTTGTGCTCTTGGAGAC	unknown
TTCTATCAGCGATTGATGGC	unknown
TTCTCACTCCAACGAGGTCC	unknown
TTCTCACTCCCTTGCCTACA	unknown
TTCTCACTCCTAACATAGCA	unknown
TTCTCGAGGCATTATTGTGC	unknown
TTCTCGAGGCCAAGAGGTCA	unknown
TTCTCGAGGCCTCAAGTCGC	GACTGTGTCTCTGACAGTCTCAGAGTGT
TTCTGCACGGCGAGGTTAAC	CTGTGTGGTGAGACTCAC
TTCTGCACGGGGTATCCTTA	unknown
TTCTGCACGGTCTAATGACG	unknown
TTCTGCTTCTTCCTGATCAA	unknown
TTCTGCTTCTTGTTCCAGAC	unknown
TTCTGTCGACCGTACCGCGA	unknown
TTCTGTGACTAATCAGTGGA	unknown
TTCTGTGACTCGTTCTACGA	unknown
TTCTGTGACTGTCACGTGCT	unknown
TTCTGTGACTGTCGTCGATC	GTGAGTGTCAGTGTCAGTCACAGACTGT
TTGAAGAAGCCGATTGATAA	unknown
TTGACATCTCGATGGAGTGC	GTGACAGTGTGAGACAGTCTCACAGTCT
TTGACTCGGCAGGCACACCT	unknown
TTGACTCGGCCCAGATTCGG	unknown
TTGAGCCTGACGATAAGCAC	unknown
TTGAGGAGACCGGCGATACC	unknown
TTGAGGAGACGACTATCACA	unknown
TTGGCGCTTAGTTGGATCCT	unknown
TTGGTAAGTTCTGCAGGATA	unknown
TTGTACACGTTACAGTACGC	unknown
TTGTACATTACGATAAGCAC	unknown
TTGTCAGTGGCGGCGATACC	unknown
TTGTCAGTGGTATCGCGCCA	unknown
TTGTCTGCAGAGCAAGCGAC	CTGTCTGTGAGAGACTCTCTGAGTCTC
TTGTCTGCAGAGCAAGCGAC	TGTCTGTGAGAGACTCTCTGAGTCTCTG
TTGTCTGCAGAGCAAGCGAC	TGTCTCACTGAGAGTCTGTGTGTGTCTG
TTGTCTGCAGGCTAGTAGAA	unknown
TTGTCTGCAGGTACATAGGC	unknown
TTGTGGCATCATGTCTGCCA	unknown
TTGTGGCATCTAACAGCCAA	unknown
